COPY pre.lang (lang_code, diacr, real_code) FROM stdin;
aa	t	aa
ab	t	ab
ae	f	ae
af	f	af
ak	f	ak
am	f	am
an	f	an
ar	t	ar
as	f	as
av	t	av
ay	f	ay
az	f	az
ba	f	ba
be	t	be
bg	t	bg
bh	f	bh
bi	f	bi
bm	f	bm
bn	f	bn
bo	f	bo
br	f	br
ca	f	ca
ce	t	ce
ch	f	ch
co	f	co
cr	f	cr
cs	f	cs
cu	t	cu
cv	f	cv
cy	f	cy
da	f	da
de	f	de
dv	f	dv
dz	f	dz
ee	f	ee
el	f	el
en	f	en
eo	f	eo
es	f	es
et	f	et
eu	f	eu
fa	t	fa
ff	f	ff
fi	t	fi
fj	f	fj
fo	f	fo
fr	f	fr
fy	f	fy
ga	f	ga
gd	f	gd
gl	f	gl
gn	f	gn
gu	f	gu
gv	f	gv
ha	t	ha
he	t	he
hi	f	hi
ho	f	ho
ht	f	ht
hu	f	hu
hy	t	hy
hz	f	hz
ia	f	ia
id	f	id
ie	f	ie
ig	t	ig
ii	f	ii
ik	f	ik
io	f	io
is	f	is
it	f	it
iu	f	iu
ja	f	ja
jv	f	jv
ka	t	ka
kg	f	kg
ki	f	ki
kj	f	kj
kk	f	kk
kl	f	kl
km	f	km
kn	f	kn
ko	t	ko
kr	t	kr
ks	f	ks
kw	f	kw
ky	f	ky
la	t	la
lb	f	lb
lg	t	lg
li	f	li
ln	f	ln
lo	f	lo
lt	t	lt
lu	f	lu
lv	t	lv
mg	f	mg
mh	f	mh
mi	f	mi
mk	t	mk
ml	f	ml
mn	f	mn
mr	t	mr
ms	f	ms
mt	f	mt
my	f	my
na	f	na
nb	f	nb
nd	t	nd
ne	f	ne
ng	f	ng
nl	f	nl
nn	f	nn
no	f	no
nr	t	nr
nv	f	nv
ny	t	ny
oc	f	oc
oj	f	oj
om	f	om
or	f	or
os	t	os
pa	t	pa
pi	t	pi
pl	f	pl
ps	f	ps
pt	f	pt
qu	f	qu
rm	f	rm
ro	f	ro
ru	t	ru
rw	t	rw
sa	t	sa
sc	f	sc
sd	t	sd
se	t	se
sg	f	sg
sh	t	sh
si	f	si
sk	f	sk
sl	t	sl
sm	f	sm
sn	t	sn
so	t	so
sq	t	sq
ss	t	ss
st	t	st
su	f	su
sv	f	sv
sw	f	sw
ta	f	ta
te	f	te
tg	t	tg
th	f	th
ti	f	ti
tk	t	tk
tl	t	tl
tn	f	tn
to	t	to
tr	f	tr
ts	f	ts
tt	f	tt
ty	f	ty
ug	f	ug
uk	t	uk
ur	t	ur
uz	f	uz
ve	f	ve
vi	f	vi
vo	f	vo
wa	f	wa
wo	f	wo
xh	t	xh
yi	f	yi
yo	t	yo
za	f	za
zh	f	zh
zu	t	zu
aaa	f	aaa
aab	f	aab
aac	f	aac
aad	f	aad
aaf	f	aaf
aag	f	aag
aah	f	aah
aai	f	aai
aak	f	aak
aal	f	aal
aan	f	aan
aap	f	aap
aaq	f	aaq
aas	f	aas
aau	f	aau
aaw	f	aaw
aax	f	aax
aaz	f	aaz
aba	f	aba
abb	f	abb
abc	f	abc
abd	f	abd
abe	f	abe
abf	f	abf
abg	f	abg
abh	f	abh
abi	f	abi
abj	f	abj
abl	f	abl
abm	f	abm
abn	f	abn
abo	f	abo
abp	f	abp
abq	f	abq
abr	f	abr
abs	f	abs
abt	f	abt
abu	f	abu
abv	t	abv
abw	f	abw
abx	f	abx
aby	f	aby
abz	f	abz
aca	f	aca
acb	f	acb
acd	f	acd
ace	f	ace
ach	f	ach
aci	f	aci
ack	f	ack
acl	f	acl
acm	t	acm
acn	f	acn
acp	f	acp
acr	f	acr
acs	f	acs
acu	f	acu
acv	f	acv
acw	t	acw
acx	t	acx
acy	f	acy
acz	f	acz
ada	f	ada
adb	f	adb
add	f	add
ade	f	ade
adf	t	adf
adg	f	adg
adh	f	adh
adi	f	adi
adj	f	adj
adl	f	adl
adn	f	adn
ado	f	ado
adp	f	adp
adq	f	adq
adr	f	adr
ads	f	ads
adt	f	adt
adu	f	adu
adw	f	adw
ady	f	ady
adz	f	adz
aea	f	aea
aeb	t	aeb
aed	f	aed
aee	f	aee
aek	f	aek
ael	f	ael
aem	f	aem
aen	f	aen
aeq	f	aeq
aer	f	aer
aes	f	aes
aeu	f	aeu
aew	f	aew
aey	f	aey
aez	f	aez
afb	t	afb
afd	f	afd
afe	f	afe
afg	f	afg
afh	f	afh
afi	f	afi
afk	f	afk
afn	f	afn
afo	f	afo
afp	f	afp
afs	f	afs
aft	f	aft
afu	f	afu
afz	f	afz
aga	f	aga
agb	f	agb
agc	f	agc
agd	f	agd
age	f	age
agf	f	agf
agg	f	agg
agh	f	agh
agi	f	agi
agj	f	agj
agk	f	agk
agl	f	agl
agm	f	agm
agn	f	agn
ago	f	ago
agq	f	agq
agr	f	agr
ags	f	ags
agt	f	agt
agu	f	agu
agv	f	agv
agw	f	agw
agx	f	agx
agy	f	agy
agz	f	agz
aha	f	aha
ahb	f	ahb
ahg	f	ahg
ahh	f	ahh
ahi	f	ahi
ahk	f	ahk
ahl	f	ahl
ahm	f	ahm
ahn	f	ahn
aho	f	aho
ahp	f	ahp
ahr	f	ahr
ahs	f	ahs
aht	f	aht
aia	f	aia
aib	f	aib
aic	f	aic
aid	f	aid
aie	f	aie
aif	f	aif
aig	f	aig
aih	f	aih
aii	t	aii
aij	f	aij
aik	f	aik
ail	f	ail
aim	f	aim
ain	f	ain
aio	t	aio
aip	f	aip
air	f	air
ait	f	ait
aiw	f	aiw
aix	f	aix
aiy	f	aiy
aja	f	aja
ajg	f	ajg
aji	f	aji
ajn	f	ajn
ajp	t	ajp
ajw	f	ajw
ajz	f	ajz
akb	f	akb
akc	f	akc
akd	f	akd
ake	f	ake
akf	f	akf
akg	f	akg
akh	f	akh
aki	f	aki
akj	f	akj
akk	f	akk
akl	f	akl
akm	f	akm
ako	f	ako
akp	f	akp
akq	f	akq
akr	f	akr
aks	f	aks
akt	f	akt
aku	f	aku
akv	f	akv
akw	f	akw
akx	f	akx
aky	f	aky
akz	f	akz
ala	f	ala
alc	f	alc
ald	f	ald
ale	f	ale
alf	f	alf
alh	f	alh
ali	f	ali
alj	f	alj
alk	f	alk
all	f	all
alm	f	alm
alo	f	alo
alp	f	alp
alq	f	alq
alr	f	alr
alt	f	alt
alu	f	alu
alw	f	alw
alx	f	alx
aly	f	aly
alz	f	alz
ama	f	ama
amb	f	amb
amc	f	amc
ame	f	ame
amf	f	amf
amg	f	amg
ami	f	ami
amj	f	amj
amk	f	amk
aml	f	aml
amm	f	amm
amn	f	amn
amo	f	amo
amp	f	amp
amq	f	amq
amr	f	amr
ams	f	ams
amt	f	amt
amu	f	amu
amv	f	amv
amw	f	amw
amx	f	amx
amy	f	amy
amz	f	amz
ana	f	ana
anb	f	anb
anc	f	anc
and	f	and
ane	f	ane
anf	f	anf
ang	t	ang
anh	f	anh
ani	f	ani
anj	f	anj
ank	f	ank
anl	f	anl
anm	f	anm
ann	f	ann
ano	f	ano
anp	f	anp
anq	f	anq
anr	f	anr
ans	f	ans
ant	f	ant
anu	f	anu
anv	f	anv
anw	f	anw
anx	f	anx
any	f	any
anz	f	anz
aoa	f	aoa
aob	f	aob
aoc	f	aoc
aod	f	aod
aoe	f	aoe
aof	f	aof
aog	f	aog
aoi	f	aoi
aoj	f	aoj
aok	f	aok
aol	f	aol
aom	f	aom
aon	f	aon
aor	f	aor
aos	f	aos
aot	f	aot
aou	f	aou
aox	f	aox
aoz	f	aoz
apb	f	apb
apc	t	apc
apd	t	apd
ape	f	ape
apf	f	apf
apg	f	apg
aph	f	aph
api	f	api
apj	f	apj
apk	f	apk
apl	f	apl
apm	f	apm
apn	f	apn
apo	f	apo
app	f	app
apq	f	apq
apr	f	apr
aps	f	aps
apt	f	apt
apu	f	apu
apv	f	apv
apw	f	apw
apx	f	apx
apy	f	apy
apz	f	apz
aqc	f	aqc
aqd	f	aqd
aqg	f	aqg
aqm	f	aqm
aqn	f	aqn
aqp	f	aqp
aqr	f	aqr
aqt	f	aqt
aqz	f	aqz
arc	t	arc
ard	f	ard
are	f	are
arh	f	arh
ari	f	ari
arj	f	arj
ark	f	ark
arl	f	arl
arn	f	arn
aro	f	aro
arp	f	arp
arq	t	arq
arr	f	arr
ars	t	ars
aru	f	aru
arv	f	arv
arw	f	arw
arx	f	arx
ary	t	ary
arz	t	arz
asa	f	asa
asb	f	asb
asc	f	asc
ase	f	ase
asf	f	asf
asg	f	asg
ash	f	ash
asi	f	asi
asj	f	asj
ask	f	ask
asl	f	asl
asn	f	asn
aso	f	aso
asp	f	asp
asq	f	asq
asr	f	asr
ass	f	ass
ast	f	ast
asu	f	asu
asv	f	asv
asw	f	asw
asx	f	asx
asy	f	asy
asz	f	asz
ata	f	ata
atb	f	atb
atc	f	atc
atd	f	atd
ate	f	ate
atg	f	atg
ati	f	ati
atj	f	atj
atk	f	atk
atl	f	atl
atm	f	atm
ato	f	ato
atp	f	atp
atq	f	atq
atr	f	atr
ats	f	ats
att	f	att
atu	f	atu
atv	f	atv
atw	f	atw
atx	f	atx
aty	f	aty
atz	f	atz
aua	f	aua
aub	f	aub
auc	f	auc
aud	f	aud
aug	f	aug
auh	f	auh
aui	f	aui
auj	f	auj
auk	f	auk
aul	f	aul
aum	f	aum
aun	f	aun
auo	f	auo
aup	f	aup
auq	f	auq
aur	f	aur
aut	f	aut
auu	f	auu
auw	f	auw
aux	f	aux
auy	f	auy
auz	f	auz
avb	f	avb
avd	f	avd
avi	f	avi
avk	f	avk
avm	f	avm
avn	f	avn
avo	f	avo
avs	f	avs
avt	f	avt
avu	f	avu
avv	f	avv
awa	f	awa
awb	f	awb
awc	f	awc
awe	f	awe
awg	f	awg
awh	f	awh
awi	f	awi
awk	f	awk
awm	f	awm
awn	f	awn
awo	f	awo
awr	f	awr
aws	f	aws
awt	f	awt
awu	f	awu
awv	f	awv
aww	f	aww
awx	f	awx
awy	f	awy
axb	f	axb
axe	f	axe
axg	f	axg
axk	f	axk
axl	f	axl
axm	t	axm
axx	f	axx
aya	f	aya
ayb	f	ayb
ayd	f	ayd
aye	f	aye
ayg	f	ayg
ayi	f	ayi
ayk	f	ayk
ayl	t	ayl
ayn	t	ayn
ayo	f	ayo
ayp	t	ayp
ayq	f	ayq
ays	f	ays
ayt	f	ayt
ayu	f	ayu
ayy	f	ayy
ayz	f	ayz
aza	f	aza
azd	f	azd
azg	f	azg
azm	f	azm
azn	f	azn
azo	f	azo
azt	f	azt
azz	f	azz
baa	f	baa
bab	f	bab
bac	f	bac
bae	f	bae
baf	f	baf
bag	f	bag
bah	f	bah
baj	f	baj
bal	f	bal
ban	f	ban
bao	f	bao
bap	f	bap
bar	f	bar
bas	f	bas
bau	f	bau
bav	f	bav
baw	f	baw
bax	f	bax
bay	f	bay
bba	f	bba
bbb	f	bbb
bbc	f	bbc
bbd	f	bbd
bbe	f	bbe
bbf	f	bbf
bbg	f	bbg
bbh	f	bbh
bbi	f	bbi
bbj	f	bbj
bbk	f	bbk
bbl	t	bbl
bbm	f	bbm
bbn	f	bbn
bbo	f	bbo
bbp	f	bbp
bbq	f	bbq
bbr	f	bbr
bbs	f	bbs
bbt	f	bbt
bbu	f	bbu
bbv	f	bbv
bbw	f	bbw
bbx	f	bbx
bby	f	bby
bca	f	bca
bcb	f	bcb
bcd	f	bcd
bce	f	bce
bcf	f	bcf
bcg	f	bcg
bch	f	bch
bci	f	bci
bcj	f	bcj
bck	f	bck
bcl	f	bcl
bcm	f	bcm
bcn	f	bcn
bco	f	bco
bcp	f	bcp
bcq	f	bcq
bcr	f	bcr
bcs	f	bcs
bct	f	bct
bcu	f	bcu
bcv	f	bcv
bcw	f	bcw
bcy	f	bcy
bcz	f	bcz
bda	f	bda
bdb	f	bdb
bdc	f	bdc
bdd	f	bdd
bde	f	bde
bdf	f	bdf
bdg	f	bdg
bdh	f	bdh
bdi	f	bdi
bdj	f	bdj
bdk	t	bdk
bdl	f	bdl
bdm	f	bdm
bdn	f	bdn
bdo	f	bdo
bdp	f	bdp
bdq	f	bdq
bdr	f	bdr
bds	f	bds
bdt	f	bdt
bdu	f	bdu
bdv	f	bdv
bdw	f	bdw
bdx	f	bdx
bdy	f	bdy
bdz	f	bdz
bea	f	bea
beb	f	beb
bec	f	bec
bed	f	bed
bee	f	bee
bef	f	bef
beg	f	beg
beh	f	beh
bei	f	bei
bej	f	bej
bek	f	bek
bem	f	bem
beo	f	beo
bep	f	bep
beq	f	beq
bes	f	bes
bet	f	bet
beu	f	beu
bev	f	bev
bew	f	bew
bex	f	bex
bey	f	bey
bez	f	bez
bfa	f	bfa
bfb	f	bfb
bfc	f	bfc
bfd	f	bfd
bfe	f	bfe
bff	f	bff
bfg	f	bfg
bfh	f	bfh
bfi	f	bfi
bfj	f	bfj
bfk	f	bfk
bfl	f	bfl
bfm	f	bfm
bfn	f	bfn
bfo	f	bfo
bfp	f	bfp
bfq	f	bfq
bfr	f	bfr
bfs	f	bfs
bft	f	bft
bfu	f	bfu
bfw	f	bfw
bfx	f	bfx
bfy	f	bfy
bfz	f	bfz
bga	f	bga
bgb	f	bgb
bgc	f	bgc
bgd	f	bgd
bge	f	bge
bgf	f	bgf
bgg	f	bgg
bgi	f	bgi
bgj	f	bgj
bgk	f	bgk
bgl	f	bgl
bgo	f	bgo
bgq	f	bgq
bgr	f	bgr
bgs	f	bgs
bgt	f	bgt
bgu	f	bgu
bgv	f	bgv
bgw	f	bgw
bgx	f	bgx
bgy	f	bgy
bgz	f	bgz
bha	f	bha
bhb	f	bhb
bhc	f	bhc
bhd	f	bhd
bhe	f	bhe
bhf	f	bhf
bhg	f	bhg
bhh	f	bhh
bhi	f	bhi
bhj	f	bhj
bhl	f	bhl
bhm	f	bhm
bhn	f	bhn
bho	f	bho
bhp	f	bhp
bhq	f	bhq
bhs	f	bhs
bht	f	bht
bhu	f	bhu
bhv	f	bhv
bhw	f	bhw
bhx	f	bhx
bhy	f	bhy
bhz	f	bhz
bia	f	bia
bib	f	bib
bic	f	bic
bid	f	bid
bie	f	bie
bif	f	bif
big	f	big
bij	f	bij
bil	f	bil
bim	f	bim
bin	t	bin
bio	f	bio
bip	f	bip
biq	f	biq
bir	f	bir
bit	f	bit
biu	f	biu
biv	f	biv
biw	f	biw
bix	f	bix
biy	f	biy
biz	f	biz
bja	f	bja
bjb	f	bjb
bjc	f	bjc
bje	f	bje
bjf	f	bjf
bjg	f	bjg
bjh	f	bjh
bji	f	bji
bjj	f	bjj
bjk	f	bjk
bjl	f	bjl
bjm	f	bjm
bjn	f	bjn
bjo	f	bjo
bjp	f	bjp
bjr	f	bjr
bjs	f	bjs
bjt	f	bjt
bju	f	bju
bjv	f	bjv
bjw	f	bjw
bjx	f	bjx
bjy	f	bjy
bjz	f	bjz
bka	f	bka
bkc	f	bkc
bkd	f	bkd
bkf	f	bkf
bkg	f	bkg
bkh	f	bkh
bki	f	bki
bkj	f	bkj
bkk	f	bkk
bkl	f	bkl
bkm	f	bkm
bkn	f	bkn
bko	f	bko
bkp	f	bkp
bkq	f	bkq
bkr	f	bkr
bks	f	bks
bkt	f	bkt
bku	f	bku
bkv	f	bkv
bkw	f	bkw
bkx	f	bkx
bky	f	bky
bkz	f	bkz
bla	f	bla
blb	f	blb
blc	f	blc
bld	f	bld
ble	f	ble
blf	f	blf
blg	f	blg
blh	f	blh
bli	f	bli
blj	f	blj
blk	f	blk
bll	f	bll
blm	f	blm
bln	f	bln
blo	f	blo
blp	f	blp
blq	f	blq
blr	f	blr
bls	f	bls
blt	f	blt
blv	f	blv
blw	f	blw
blx	f	blx
bly	f	bly
blz	f	blz
bma	f	bma
bmb	f	bmb
bmc	f	bmc
bmd	f	bmd
bme	f	bme
bmf	f	bmf
bmg	f	bmg
bmh	f	bmh
bmi	f	bmi
bmj	f	bmj
bmk	f	bmk
bml	f	bml
bmn	f	bmn
bmo	f	bmo
bmp	f	bmp
bmq	f	bmq
bmr	f	bmr
bmt	f	bmt
bmu	f	bmu
bmv	f	bmv
bmw	f	bmw
bmx	f	bmx
bmz	f	bmz
bna	f	bna
bnb	f	bnb
bnd	f	bad
bne	f	bne
bnf	f	bnf
bng	f	bng
bni	f	bni
bnj	f	bnj
bnk	f	bnk
bnl	f	bnl
bnm	f	bnm
bnn	f	bnn
bno	f	bno
bnp	f	bnp
bnq	f	bnq
bnr	f	bnr
bns	f	bns
bnu	f	bnu
bnv	f	bnv
bnw	f	bnw
bnx	f	bnx
bny	f	bny
bnz	f	bnz
boa	f	boa
bob	f	bob
boe	f	boe
bof	f	bof
bog	f	bog
boh	f	boh
boi	f	boi
boj	f	boj
bok	f	bok
bol	f	bol
bom	f	bom
bon	f	bon
boo	f	boo
bop	f	bop
boq	f	boq
bor	f	bor
bot	f	bot
bou	f	bou
bov	f	bov
bow	f	bow
box	f	box
boy	f	boy
boz	f	boz
bpa	f	bpa
bpd	f	bpd
bpg	f	bpg
bph	f	bph
bpi	f	bpi
bpj	f	bpj
bpk	f	bpk
bpl	f	bpl
bpm	f	bpm
bpn	f	bpn
bpo	f	bpo
bpp	f	bpp
bpq	f	bpq
bpr	f	bpr
bps	f	bps
bpt	f	bpt
bpu	f	bpu
bpv	f	bpv
bpx	f	bpx
bpy	f	bpy
bpz	f	bpz
bqa	f	bqa
bqb	f	bqb
bqc	f	bqc
bqd	f	bqd
bqf	f	bqf
bqg	f	bqg
bqh	f	bqh
bqi	f	bqi
bqj	f	bqj
bqk	f	bqk
bql	f	bql
bqm	f	bqm
bqn	f	bqn
bqo	f	bqo
bqp	f	bqp
bqq	f	bqq
bqr	f	bqr
bqs	f	bqs
bqt	f	bqt
bqu	f	bqu
bqv	f	bqv
bqw	f	bqw
bqx	f	bqx
bqy	f	bqy
bqz	f	bqz
bra	f	bra
brb	f	brb
brc	f	brc
brd	f	brd
brf	f	brf
brg	f	brg
brh	f	brh
bri	f	bri
brj	f	brj
brk	f	brk
brl	f	brl
brm	f	brm
brn	f	brn
bro	f	bro
brp	f	brp
brq	f	brq
brr	f	brr
brs	f	brs
brt	f	brt
bru	f	bru
brv	f	brv
brw	f	brw
brx	f	brx
bry	f	bry
brz	f	brz
bsa	f	bsa
bsb	f	bsb
bsc	f	bsc
bse	f	bse
bsf	f	bsf
bsg	f	bsg
bsh	f	bsh
bsi	f	bsi
bsj	f	bsj
bsk	f	bsk
bsl	f	bsl
bsm	f	bsm
bsn	f	bsn
bso	f	bso
bsp	f	bsp
bsq	f	bsq
bsr	f	bsr
bss	f	bss
bst	f	bst
bsu	f	bsu
bsv	f	bsv
bsw	f	bsw
bsx	f	bsx
bsy	f	bsy
bta	f	bta
btc	f	btc
btd	f	btd
bte	f	bte
btf	f	btf
btg	f	btg
bth	f	bth
bti	f	bti
btj	f	btj
btm	f	btm
btn	f	btn
bto	f	bto
btp	f	btp
btq	f	btq
btr	f	btr
bts	f	bts
btt	f	btt
btu	f	btu
btv	f	btv
btw	f	btw
btx	f	btx
bty	f	bty
btz	f	btz
bua	f	bua
bub	f	bub
bud	f	bud
bue	f	bue
buf	f	buf
bug	f	bug
buh	f	buh
bui	f	bui
buj	f	buj
buk	f	buk
bum	f	bum
bun	f	bun
buo	f	buo
bup	f	bup
buq	f	buq
bus	f	bus
but	f	but
buu	f	buu
buv	f	buv
buw	f	buw
bux	f	bux
buy	f	buy
bva	f	bva
bvb	f	bvb
bvc	f	bvc
bvd	f	bvd
bve	f	bve
bvf	f	bvf
bvg	f	bvg
bvh	f	bvh
bvi	f	bvi
bvj	f	bvj
bvk	f	bvk
bvl	f	bvl
bvm	f	bvm
bvn	f	bvn
bvo	f	bvo
bvp	f	bvp
bvq	f	bvq
bvr	f	bvr
bvt	f	bvt
bvu	f	bvu
bvv	f	bvv
bvw	f	bvw
bvx	f	bvx
bvy	f	bvy
bvz	f	bvz
bwa	f	bwa
bwb	f	bwb
bwc	f	bwc
bwd	f	bwd
bwe	f	bwe
bwf	f	bwf
bwg	f	bwg
bwh	f	bwh
bwi	f	bwi
bwj	f	bwj
bwk	f	bwk
bwl	f	bwl
bwm	f	bwm
bwn	f	bwn
bwo	f	bwo
bwp	f	bwp
bwq	f	bwq
bwr	f	bwr
bws	f	bws
bwt	f	bwt
bwu	f	bwu
bww	f	bww
bwx	f	bwx
bwy	f	bwy
bwz	f	bwz
bxa	f	bxa
bxb	f	bxb
bxc	f	bxc
bxd	f	bxd
bxe	f	bxe
bxf	f	bxf
bxg	f	bxg
bxh	f	bxh
bxi	f	bxi
bxj	f	bxj
bxk	f	bxk
bxl	f	bxl
bxn	f	bxn
bxo	f	bxo
bxp	f	bxp
bxq	f	bxq
bxs	f	bxs
bxv	f	bxv
bxw	f	bxw
bxz	f	bxz
bya	f	bya
byb	f	byb
byc	f	byc
byd	f	byd
bye	f	bye
byf	f	byf
byg	f	byg
byh	f	byh
byi	f	byi
byj	f	byj
byk	f	byk
byl	f	byl
bym	f	bym
byn	f	byn
byo	f	byo
byp	f	byp
byq	f	byq
byr	f	byr
bys	f	bys
byt	f	byt
byv	f	byv
byw	f	byw
byx	f	byx
byz	f	byz
bza	f	bza
bzb	f	bzb
bzd	f	bzd
bze	f	bze
bzf	f	bzf
bzg	f	bzg
bzh	f	bzh
bzi	f	bzi
bzj	f	bzj
bzk	f	bzk
bzl	f	bzl
bzm	f	bzm
bzn	f	bzn
bzo	f	bzo
bzp	f	bzp
bzq	f	bzq
bzr	f	bzr
bzs	f	bzs
bzu	f	bzu
bzv	f	bzv
bzw	f	bzw
bzx	f	bzx
bzy	f	bzy
bzz	f	bzz
caa	f	caa
cab	f	cab
cac	f	cac
cad	f	cad
cae	f	cae
caf	f	caf
cag	f	cag
cah	f	cah
caj	f	caj
cak	f	cak
cal	f	cal
cam	f	cam
can	f	can
cao	f	cao
cap	f	cap
caq	f	caq
car	f	car
cas	f	cas
cav	f	cav
caw	f	caw
cax	f	cax
cay	f	cay
caz	f	caz
cbb	f	cbb
cbc	f	cbc
cbd	f	cbd
cbg	f	cbg
cbi	f	cbi
cbj	f	cbj
cbk	f	cbk
cbl	f	cbl
cbn	f	cbn
cbo	f	cbo
cbq	f	cbq
cbr	f	cbr
cbs	f	cbs
cbt	f	cbt
cbu	f	cbu
cbv	f	cbv
cbw	f	cbw
cby	f	cby
cca	f	cca
ccc	f	ccc
ccd	f	ccd
cce	f	cce
ccg	f	ccg
cch	f	cch
ccj	f	ccj
ccl	f	ccl
ccm	f	ccm
cco	f	cco
ccp	f	ccp
ccr	f	ccr
cda	f	cda
cde	f	cde
cdf	f	cdf
cdh	f	cdh
cdi	f	cdi
cdj	f	cdj
cdm	f	cdm
cdn	f	cdn
cdo	f	cdo
cdr	f	cdr
cds	f	cds
cdy	f	cdy
cdz	f	cdz
cea	f	cea
ceb	f	ceb
ceg	f	ceg
cen	f	cen
cet	f	cet
cfa	f	cfa
cfd	f	cfd
cfg	f	cfg
cfm	f	cfm
cga	f	cga
cgc	f	cgc
cgg	f	cgg
cgk	f	cgk
chb	f	chb
chc	f	chc
chd	f	chd
chf	f	chf
chg	t	chg
chh	f	chh
chj	f	chj
chk	f	chk
chl	t	chl
chm	t	chm
chn	f	chn
cho	f	cho
chp	f	chp
chq	f	chq
chr	f	chr
cht	f	cht
chw	f	chw
chx	f	chx
chy	f	chy
chz	f	chz
cia	f	cia
cib	f	cib
cic	f	cic
cid	f	cid
cie	f	cie
cih	f	cih
cik	f	cik
cim	t	cim
cin	f	cin
cip	f	cip
cir	f	cir
ciy	f	ciy
cja	f	cja
cje	f	cje
cjh	f	cjh
cji	f	cji
cjk	f	cjk
cjm	f	cjm
cjn	f	cjn
cjo	f	cjo
cjp	f	cjp
cjs	f	cjs
cjv	f	cjv
cjy	f	cjy
ckb	t	ckb
ckh	f	ckh
ckl	f	ckl
ckn	f	ckn
cko	f	cko
ckq	f	ckq
ckr	f	ckr
cks	f	cks
ckt	f	ckt
cku	f	cku
ckv	f	ckv
ckx	f	ckx
cky	f	cky
ckz	f	ckz
cla	f	cla
clc	f	clc
cld	f	cld
cle	f	cle
clh	f	clh
cli	f	cli
clj	f	clj
clk	f	clk
cll	f	cll
clm	f	clm
clo	f	clo
clt	f	clt
clu	f	clu
clw	f	clw
cly	f	cly
cma	f	cma
cme	f	cme
cmg	f	cmg
cmi	f	cmi
cml	f	cml
cmm	f	cmm
cmn	f	cmn
cmo	f	cmo
cmr	f	cmr
cms	f	cms
cmt	f	cmt
cna	f	cna
cnb	f	cnb
cnc	f	cnc
cng	f	cng
cnh	f	cnh
cni	f	cni
cnk	f	cnk
cnl	f	cnl
cno	f	cno
cns	f	cns
cnt	f	cnt
cnu	f	cnu
cnw	f	cnw
cnx	f	cnx
coa	f	coa
cob	f	cob
coc	f	coc
cod	f	cod
coe	f	coe
cof	f	cof
cog	f	cog
coh	f	coh
coj	f	coj
cok	f	cok
col	f	col
com	f	com
con	f	con
coo	f	coo
cop	t	cop
coq	f	coq
cot	f	cot
cou	f	cou
cov	f	cov
cow	f	cow
cox	f	cox
coy	f	coy
coz	f	coz
cpa	f	cpa
cpb	f	cpb
cpc	f	cpc
cpg	f	cpg
cpi	f	cpi
cpn	f	cpn
cpo	f	cpo
cps	f	cps
cpu	f	cpu
cpx	f	cpx
cpy	f	cpy
cqd	f	cqd
cra	f	cra
crb	f	crb
crc	f	crc
crd	f	crd
crf	f	crf
crg	f	crg
crh	f	crh
cri	f	cri
crj	f	crj
crk	f	crk
crl	f	crl
crm	f	crm
crn	f	crn
cro	f	cro
crq	f	crq
crr	f	crr
crs	f	crs
crt	f	crt
crv	f	crv
crw	f	crw
crx	f	crx
cry	f	cry
crz	f	crz
csa	f	csa
csb	f	csb
csc	f	csc
csd	f	csd
cse	f	cse
csf	f	csf
csg	f	csg
csh	f	csh
csi	f	csi
csj	f	csj
csk	f	csk
csl	f	csl
csm	f	csm
csn	f	csn
cso	f	cso
csq	f	csq
csr	f	csr
css	f	css
cst	f	cst
csv	f	csv
csw	f	csw
csy	f	csy
csz	f	csz
cta	f	cta
ctc	f	ctc
ctd	f	ctd
cte	f	cte
ctg	f	ctg
cth	f	cth
ctl	f	ctl
ctm	f	ctm
ctn	f	ctn
cto	f	cto
ctp	t	ctp
cts	f	cts
ctt	f	ctt
ctu	f	ctu
ctz	f	ctz
cua	f	cua
cub	f	cub
cuc	f	cuc
cug	f	cug
cuh	f	cuh
cui	f	cui
cuj	f	cuj
cuk	f	cuk
cul	f	cul
cuo	f	cuo
cup	f	cup
cuq	f	cuq
cur	f	cur
cut	f	cut
cuu	f	cuu
cuv	f	cuv
cuw	f	cuw
cux	f	cux
cuy	f	cuy
cvg	f	cvg
cvn	f	cvn
cwa	f	cwa
cwb	f	cwb
cwd	f	cwd
cwe	f	cwe
cwg	f	cwg
cwt	f	cwt
cya	f	cya
cyb	f	cyb
cyo	f	cyo
czh	f	czh
czk	f	czk
czn	f	czn
czo	f	czo
czt	f	czt
daa	f	daa
dac	f	dac
dad	f	dad
dae	f	dae
dag	f	dag
dah	f	dah
dai	f	dai
daj	f	daj
dak	f	dak
dal	f	dal
dam	f	dam
dao	f	dao
daq	f	daq
dar	f	dar
das	f	das
dau	f	dau
dav	f	dav
daw	f	daw
dax	f	dax
daz	f	daz
dba	f	dba
dbb	f	dbb
dbd	f	dbd
dbe	f	dbe
dbf	f	dbf
dbg	f	dbg
dbi	f	dbi
dbj	f	dbj
dbl	f	dbl
dbm	f	dbm
dbn	f	dbn
dbo	f	dbo
dbp	f	dbp
dbq	f	dbq
dbr	f	dbr
dbt	f	dbt
dbu	f	dbu
dbv	f	dbv
dbw	f	dbw
dby	f	dby
dcc	f	dcc
dcr	f	dcr
dda	f	dda
ddd	f	ddd
dde	f	dde
ddg	f	ddg
ddi	f	ddi
ddj	f	ddj
ddn	f	ddn
ddo	f	ddo
ddr	f	ddr
dds	f	dds
ddw	f	ddw
dec	f	dec
ded	f	ded
dee	f	dee
def	f	def
deg	f	deg
deh	f	deh
dei	f	dei
dek	f	dek
dem	f	dem
den	f	den
dep	f	dep
der	f	der
des	f	des
dev	f	dev
dez	f	dez
dga	f	dga
dgb	f	dgb
dgc	f	dgc
dgd	f	dgd
dge	f	dge
dgg	f	dgg
dgh	f	dgh
dgi	f	dgi
dgk	f	dgk
dgn	f	dgn
dgo	f	dgo
dgr	f	dgr
dgs	f	dgs
dgt	f	dgt
dgw	f	dgw
dgx	f	dgx
dgz	f	dgz
dhg	f	dhg
dhi	f	dhi
dhl	f	dhl
dhm	f	dhm
dhn	f	dhn
dho	f	dho
dhr	f	dhr
dhs	f	dhs
dhu	f	dhu
dhv	f	dhv
dhw	f	dhw
dhx	f	dhx
dia	f	dia
dib	f	dib
dic	f	dic
did	f	did
dif	f	dif
dig	f	dig
dii	f	dii
dij	f	dij
dik	f	dik
dil	f	dil
dim	f	dim
din	f	din
dio	f	dio
dip	f	dip
dir	f	dir
dis	f	dis
diu	f	diu
diw	f	diw
dix	f	dix
diy	f	diy
diz	f	diz
dja	f	dja
djb	f	djb
djc	f	djc
djd	f	djd
dje	f	dje
djf	f	djf
dji	f	dji
djj	f	djj
djk	f	djk
djl	f	djl
djm	f	djm
djn	f	djn
djo	f	djo
djr	f	djr
dju	f	dju
djw	f	djw
dka	f	dka
dkk	f	dkk
dkr	f	dkr
dks	f	dks
dkx	f	dkx
dlg	f	dlg
dlk	f	dlk
dlm	f	dlm
dln	f	dln
dma	f	dma
dmb	f	dmb
dmc	f	dmc
dmd	f	dmd
dme	f	dme
dmf	f	dmf
dmg	f	dmg
dmk	f	dmk
dml	f	dml
dmm	f	dmm
dmo	f	dmo
dmr	f	dmr
dms	f	dms
dmu	f	dmu
dmv	f	dmv
dmw	f	dmw
dmx	f	dmx
dmy	f	dmy
dna	f	dna
dnd	f	dnd
dne	f	dne
dng	f	dng
dni	f	dni
dnj	f	dnj
dnk	f	dnk
dnn	f	dnn
dno	f	dno
dnr	f	dnr
dnt	f	dnt
dnu	f	dnu
dnv	f	dnv
dnw	f	dnw
dny	f	dny
doa	f	doa
dob	f	dob
doc	f	doc
doe	f	doe
dof	f	dof
doh	f	doh
doi	f	doi
dok	f	dok
dol	f	dol
don	f	don
doo	f	doo
dop	f	dop
doq	f	doq
dor	f	dor
dos	f	dos
dot	f	dot
dov	f	dov
dow	f	dow
dox	f	dox
doy	f	doy
doz	f	doz
dpp	f	dpp
drb	f	drb
drc	f	drc
drd	f	drd
drg	f	drg
dri	f	dri
drl	f	drl
drn	f	drn
dro	f	dro
drq	f	drq
drs	f	drs
dru	f	dru
dry	f	dry
dsb	f	dsb
dse	f	dse
dsh	f	dsh
dsi	f	dsi
dsl	f	dsl
dsn	f	dsn
dso	f	dso
dsq	f	dsq
dta	f	dta
dtb	f	dtb
dtd	f	dtd
dth	f	dth
dti	f	dti
dtk	f	dtk
dtm	f	dtm
dto	f	dto
dtp	f	dtp
dtr	f	dtr
dts	f	dts
dtt	f	dtt
dtu	f	dtu
dty	f	dty
dua	f	dua
dub	f	dub
duc	f	duc
due	f	due
duf	f	duf
dug	f	dug
duh	f	duh
dui	f	dui
duk	f	duk
dul	f	dul
dum	t	dum
dun	f	dun
duo	f	duo
dup	f	dup
duq	f	duq
dur	f	dur
dus	f	dus
duu	f	duu
duv	f	duv
duw	f	duw
dux	f	dux
duy	f	duy
duz	f	duz
dva	f	dva
dwa	f	dwa
dwr	f	dwr
dwu	f	dwu
dww	f	dww
dwy	f	dwy
dwz	f	dwz
dya	f	dya
dyb	f	dyb
dyd	f	dyd
dyg	f	dyg
dyi	f	dyi
dym	f	dym
dyn	f	dyn
dyo	f	dyo
dyu	f	dyu
dyy	f	dyy
dza	f	dza
dzg	f	dzg
dzl	f	dzl
dzn	f	dzn
ebg	f	ebg
ebk	f	ebk
ebr	f	ebr
ebu	f	ebu
ecr	f	ecr
ecs	f	ecs
ecy	f	ecy
eee	f	eee
efa	f	efa
efe	f	efe
efi	f	efi
ega	f	ega
egl	f	egl
ego	f	ego
egy	f	egx
ehu	f	ehu
eip	f	eip
eit	f	eit
eiv	f	eiv
eja	f	eja
eka	f	eka
eke	f	eke
ekg	f	ekg
eki	f	eki
ekl	f	ekl
ekm	f	ekm
eko	f	eko
ekp	f	ekp
ekr	f	ekr
eky	f	eky
ele	f	ele
elh	f	elh
eli	f	eli
elk	f	elk
elm	f	elm
elo	f	elo
elu	f	elu
elx	f	elx
ema	f	ema
emb	f	emb
eme	f	eme
emg	f	emg
emi	f	emi
emk	f	emk
emm	f	emm
emn	f	emn
emp	f	emp
ems	f	ems
emu	f	emu
emw	f	emw
emx	f	emx
emy	f	emy
ena	f	ena
enb	f	enb
enc	f	enc
end	f	end
enf	f	enf
enh	f	enh
enl	f	enl
enm	t	enm
enn	f	enn
eno	f	eno
enq	f	enq
enr	f	enr
enu	f	enu
env	f	env
enw	f	enw
enx	f	enx
eot	f	eot
epi	f	epi
era	f	era
erg	f	erg
erh	f	erh
eri	f	eri
erk	f	erk
ero	f	ero
err	f	err
ers	f	ers
ert	f	ert
erw	f	erw
ese	f	ese
esh	f	esh
esi	f	esi
esk	f	esk
esl	f	esl
esm	f	esm
esn	f	esn
eso	f	eso
esq	f	esq
ess	f	ess
esu	f	esu
esy	f	esy
etb	f	etb
etc	f	etc
eth	f	eth
etn	f	etn
eto	f	eto
etr	f	etr
ets	f	ets
ett	f	ett
etu	f	etu
etx	f	etx
etz	f	etz
eve	t	eve
evh	f	evh
evn	t	evn
ewo	f	ewo
ext	f	ext
eya	f	eya
eyo	f	eyo
eza	f	eza
eze	f	eze
faa	f	faa
fab	f	fab
fad	f	fad
faf	f	faf
fag	f	fag
fah	f	fah
fai	f	fai
faj	f	faj
fak	f	fak
fal	f	fal
fam	f	fam
fan	f	fan
fap	f	fap
far	f	far
fau	f	fau
fax	f	fax
fay	f	fay
faz	f	faz
fbl	f	fbl
fcs	f	fcs
fer	f	fer
ffi	f	ffi
fgr	f	fgr
fia	f	fia
fie	f	fie
fip	f	fip
fir	f	fir
fit	f	fit
fiw	f	fiw
fkk	f	fkk
fkv	f	fkv
fla	f	fla
flh	f	flh
fli	f	fli
fll	f	fll
fln	f	fln
flr	f	flr
fly	f	fly
fmp	f	fmp
fmu	f	fmu
fng	f	fng
fni	f	fni
fod	f	fod
foi	f	foi
fom	f	fom
fon	f	fon
for	f	for
fos	f	fos
fpe	f	fpe
fqs	f	fqs
frd	f	frd
frm	f	frm
fro	f	fro
frp	f	frp
frq	f	frq
frr	f	frr
frt	f	frt
fse	f	fse
fsl	f	fsl
fss	f	fss
fud	f	fud
fuj	f	fuj
fum	f	fum
fun	f	fun
fur	f	fur
fut	f	fut
fuu	f	fuu
fuy	f	fuy
fvr	f	fvr
fwa	f	fwa
fwe	f	fwe
gaa	f	gaa
gab	f	gab
gac	f	gac
gad	f	gad
gae	f	gae
gaf	f	gaf
gag	f	gag
gah	f	gah
gai	f	gai
gaj	f	gaj
gak	f	gak
gal	f	gal
gam	f	gam
gan	f	gan
gao	f	gao
gap	f	gap
gaq	f	gaq
gar	f	gar
gas	f	gas
gat	f	gat
gau	f	gau
gaw	f	gaw
gay	f	gay
gba	f	gba
gbb	f	gbb
gbd	f	gbd
gbe	f	gbe
gbf	f	gbf
gbg	f	gbg
gbh	f	gbh
gbi	f	gbi
gbj	f	gbj
gbk	f	gbk
gbl	f	gbl
gbm	f	gbm
gbn	f	gbn
gbo	f	gbo
gbp	f	gbp
gbq	f	gbq
gbr	f	gbr
gbs	f	gbs
gbu	f	gbu
gbv	f	gbv
gbw	f	gbw
gbx	f	gbx
gby	f	gby
gcc	f	gcc
gcd	f	gcd
gce	f	gce
gcf	f	gcf
gcl	f	gcl
gcn	f	gcn
gcr	f	gcr
gct	f	gct
gdb	f	gdb
gdc	f	gdc
gdd	f	gdd
gde	f	gde
gdf	f	gdf
gdg	f	gdg
gdh	f	gdh
gdi	f	gdi
gdj	f	gdj
gdk	f	gdk
gdl	f	gdl
gdm	f	gdm
gdn	f	gdn
gdo	f	gdo
gdq	f	gdq
gdr	f	gdr
gds	f	gds
gdt	f	gdt
gdu	f	gdu
gdx	f	gdx
gea	f	gea
geb	f	geb
gec	f	gec
ged	f	ged
geg	f	geg
geh	f	geh
gei	f	gei
gej	f	gej
gek	f	gek
gel	f	gel
geq	f	geq
ges	f	ges
gev	f	gev
gew	f	gew
gex	f	gex
gey	f	gey
gez	f	gez
gfk	f	gfk
gft	f	gft
gga	f	gga
ggb	f	ggb
ggd	f	ggd
gge	f	gge
ggg	f	ggg
ggk	f	ggk
ggl	f	ggl
ggn	f	ggn
ggt	f	ggt
ggu	f	ggu
ggw	f	ggw
gha	f	gha
ghe	f	ghe
ghh	f	ghh
ghk	f	ghk
ghl	f	ghl
ghn	f	ghn
gho	f	gho
ghr	f	ghr
ghs	f	ghs
ght	f	ght
gia	f	gia
gib	f	gib
gid	f	gid
gie	f	gie
gig	f	gig
gih	f	gih
gil	f	gil
gim	f	gim
gin	f	gin
gio	f	gio
gip	f	gip
giq	f	giq
gir	f	gir
gis	f	gis
git	f	git
giu	f	giu
giw	f	giw
gix	f	gix
giy	f	giy
giz	f	giz
gji	f	gji
gjk	f	gjk
gjm	f	gjm
gjn	f	gjn
gju	t	gju
gka	f	gka
gkd	f	gkd
gke	f	gke
gkn	f	gkn
gko	f	gko
gkp	f	gkp
glc	f	glc
gld	t	gld
glh	f	glh
glj	f	glj
glk	f	glk
glo	f	glo
glr	f	glr
glu	f	glu
glw	f	glw
gly	f	gly
gma	f	gma
gmb	f	gmb
gmd	f	gmd
gmg	f	gmg
gmh	t	gmh
gml	t	gml
gmm	f	gmm
gmn	f	gmn
gmu	f	gmu
gmv	f	gmv
gmx	f	gmx
gmy	f	gmy
gmz	f	gmz
gna	f	gna
gnb	f	gnb
gnc	f	gnc
gnd	f	gnd
gne	f	gne
gng	f	gng
gnh	f	gnh
gni	f	gni
gnj	f	gnj
gnk	f	gnk
gnl	f	gnl
gnm	f	gnm
gnn	f	gnn
gnq	f	gnq
gnr	f	gnr
gnt	f	gnt
gnu	f	gnu
gnw	f	gnw
gnz	f	gnz
goa	f	goa
gob	f	gob
goc	f	goc
god	f	god
goe	f	goe
gof	f	gof
gog	f	gog
goh	t	goh
goi	f	goi
goj	f	goj
gol	f	gol
gon	f	gon
goo	f	goo
gop	f	gop
goq	f	goq
gor	f	gor
got	t	got
gou	f	gou
gow	f	gow
gox	f	gox
goy	f	goy
goz	f	goz
gpa	f	gpa
gpn	f	gpn
gqa	f	gqa
gqi	f	gqi
gqn	f	gqn
gqr	f	gqr
gqu	f	gqu
gra	f	gra
grb	f	grb
grc	t	grc
grd	f	grd
grg	f	grg
grh	f	grh
gri	f	gri
grj	f	grj
grm	f	grm
gro	f	gro
grq	f	grq
grs	f	grs
grt	f	grt
gru	f	gru
grv	f	grv
grw	f	grw
grx	f	grx
gry	f	gry
grz	f	grz
gse	f	gse
gsg	f	gsg
gsl	f	gsl
gsm	f	gsm
gsn	f	gsn
gso	f	gso
gsp	f	gsp
gss	f	gss
gsw	f	gsw
gta	f	gta
gtu	f	gtu
gua	f	gua
gub	f	gub
guc	f	guc
gud	f	gud
gue	f	gue
guf	f	guf
gug	f	gug
guh	f	guh
gui	f	gui
guk	f	guk
gul	f	gul
gum	f	gum
gun	f	gun
guo	f	guo
gup	f	gup
guq	f	guq
gur	f	gur
gus	f	gus
gut	f	gut
guu	f	guu
guv	f	guv
guw	f	guw
gux	f	gux
guz	f	guz
gva	f	gva
gvc	f	gvc
gve	f	gve
gvf	f	gvf
gvj	f	gvj
gvl	f	gvl
gvm	f	gvm
gvn	f	gvn
gvo	f	gvo
gvp	f	gvp
gvr	f	gvr
gvs	f	gvs
gvy	f	gvy
gwa	f	gwa
gwb	f	gwb
gwc	f	gwc
gwd	f	gwd
gwe	f	gwe
gwf	f	gwf
gwg	f	gwg
gwi	f	gwi
gwj	f	gwj
gwm	f	gwm
gwn	f	gwn
gwr	f	gwr
gwt	f	gwt
gwu	f	gwu
gww	f	gww
gwx	f	gwx
gxx	f	gxx
gya	f	gya
gyb	f	gyb
gyd	f	gyd
gye	f	gye
gyf	f	gyf
gyg	f	gyg
gyi	f	gyi
gyl	f	gyl
gym	f	gym
gyn	f	gyn
gyo	f	gyo
gyr	f	gyr
gyy	f	gyy
gza	f	gza
gzn	f	gzn
haa	f	haa
hab	f	hab
hac	f	hac
had	f	had
haf	f	haf
hag	f	hag
hah	f	hah
hai	f	hai
haj	f	haj
hak	f	hak
hal	f	hal
ham	f	ham
hao	f	hao
hap	f	hap
har	f	har
has	f	has
hav	f	hav
haw	f	haw
hax	f	hax
hay	f	hay
haz	f	haz
hba	f	hba
hbb	f	hbb
hbn	f	hbn
hbu	f	hbu
hca	f	hca
hch	f	hch
hdn	f	hdn
hds	f	hds
hdy	f	hdy
hea	f	hea
hed	f	hed
heg	f	heg
heh	f	heh
hei	f	hei
hem	f	hem
hgm	f	hgm
hgw	f	hgw
hhi	f	hhi
hhr	f	hhr
hhy	f	hhy
hia	f	hia
hib	f	hib
hid	f	hid
hif	f	hif
hig	f	hig
hih	f	hih
hii	f	hii
hij	f	hij
hik	f	hik
hil	t	hil
hio	f	hio
hir	f	hir
hit	f	hit
hiw	f	hiw
hix	f	hix
hji	f	hji
hka	f	hka
hke	f	hke
hkk	f	hkk
hkn	f	hkn
hks	f	hks
hla	f	hla
hlb	f	hlb
hld	f	hld
hle	f	hle
hlt	f	hlt
hma	f	hma
hmb	f	hmb
hmc	f	hmc
hmd	f	hmd
hme	f	hme
hmf	f	hmf
hmg	f	hmg
hmh	f	hmh
hmi	f	hmi
hmj	f	hmj
hmk	f	hmk
hml	f	hml
hmm	f	hmm
hmp	f	hmp
hmq	f	hmq
hmr	f	hmr
hms	f	hms
hmt	f	hmt
hmu	f	hmu
hmv	f	hmv
hmw	f	hmw
hmy	f	hmy
hmz	f	hmz
hna	f	hna
hnd	f	hnd
hne	f	hne
hnh	f	hnh
hni	f	hni
hnj	f	hnj
hnn	f	hnn
hno	f	hno
hns	f	hns
hnu	f	hnu
hoa	f	hoa
hob	f	hob
hoc	f	hoc
hod	f	hod
hoe	f	hoe
hoh	f	hoh
hoi	f	hoi
hoj	f	hoj
hol	f	hol
hom	f	hom
hoo	f	hoo
hop	f	hop
hor	f	hor
hos	f	hos
hot	f	hot
hov	f	hov
how	f	how
hoy	f	hoy
hoz	f	hoz
hpo	f	hpo
hps	f	hps
hra	f	hra
hrc	f	hrc
hre	f	hre
hrk	f	hrk
hrm	f	hrm
hro	f	hro
hrp	f	hrp
hrt	f	hrt
hru	f	hru
hrw	f	hrw
hrx	f	hrx
hrz	f	hrz
hsb	f	hsb
hsh	f	hsh
hsl	f	hsl
hsn	f	hsn
hss	f	hss
hti	f	hti
hto	f	hto
hts	f	hts
htu	f	htu
hub	f	hub
huc	f	huc
hud	f	hud
huf	f	huf
hug	f	hug
huh	f	huh
hui	f	hui
huj	f	huj
huk	f	huk
hul	f	hul
hum	f	hum
huo	f	huo
hup	f	hup
huq	f	huq
hur	f	hur
hus	f	hus
huu	f	huu
huv	f	huv
huw	f	huw
hux	f	hux
huy	f	huy
huz	t	huz
hvc	f	hvc
hvk	f	hvk
hvn	f	hvn
hwa	f	hwa
hwc	f	hwc
hwo	f	hwo
hya	f	hya
iai	f	iai
ian	f	ian
iar	f	iar
iba	f	iba
ibb	f	ibb
ibd	f	ibd
ibe	f	ibe
ibg	f	ibg
ibh	f	ibh
ibl	f	ibl
ibm	f	ibm
ibn	f	ibn
ibr	f	ibr
ibu	f	ibu
iby	f	iby
ica	f	ica
ich	f	ich
icl	f	icl
icr	f	icr
ida	f	ida
idb	f	idb
idc	f	idc
idd	f	idd
ide	f	ide
idi	f	idi
idr	f	idr
ids	f	ids
idt	f	idt
idu	f	idu
ifa	f	ifa
ifb	f	ifb
ife	f	ife
iff	f	iff
ifk	f	ifk
ifm	f	ifm
ifu	f	ifu
ify	f	ify
igb	f	igb
ige	f	ige
igg	f	igg
igl	t	igl
igm	f	igm
ign	f	ign
igo	f	igo
igs	f	igs
igw	f	igw
ihb	f	ihb
ihi	f	ihi
ihp	f	ihp
ijc	f	ijc
ije	f	ije
ijj	f	ijj
ijn	f	ijn
ijs	f	ijs
ike	f	ike
iki	f	iki
ikk	f	ikk
ikl	f	ikl
iko	f	iko
ikp	f	ikp
ikr	f	ikr
iks	f	iks
ikt	f	ikt
ikv	f	ikv
ikw	f	ikw
ikx	f	ikx
ikz	f	ikz
ila	f	ila
ilb	f	ilb
ilg	f	ilg
ili	f	ili
ilk	f	ilk
ill	f	ill
ilo	t	ilo
ils	f	ils
ilu	f	ilu
ilv	f	ilv
ima	f	ima
imi	f	imi
iml	f	iml
imn	f	imn
imo	f	imo
imr	f	imr
ims	f	ims
imy	f	imy
inb	f	inb
ing	f	ing
inh	t	inh
inj	f	inj
inl	f	inl
inm	f	inm
inn	f	inn
ino	f	ino
inp	f	inp
ins	f	ins
int	f	int
inz	f	inz
ior	f	ior
iou	f	iou
iow	f	iow
ipi	f	ipi
ipo	f	ipo
iqu	f	iqu
iqw	f	iqw
ire	f	ire
irh	f	irh
iri	f	iri
irk	f	irk
irn	f	irn
irr	f	irr
iru	f	iru
irx	f	irx
iry	f	iry
isa	f	isa
isc	f	isc
isd	f	isd
ise	f	ise
isg	f	isg
ish	f	ish
isi	f	isi
isk	f	isk
ism	f	ism
isn	f	isn
iso	f	iso
isr	f	isr
ist	f	ist
isu	f	isu
itb	f	itb
itd	f	itd
ite	f	ite
iti	f	iti
itk	f	itk
itl	f	itl
itm	f	itm
ito	f	ito
itr	f	itr
its	f	its
itt	f	itt
itv	f	itv
itw	f	itw
itx	f	itx
ity	f	ity
itz	f	itz
ium	f	ium
ivb	f	ivb
ivv	f	ivv
iwk	f	iwk
iwm	f	iwm
iwo	f	iwo
iws	f	iws
ixc	f	ixc
ixl	f	ixl
iya	f	iya
iyo	f	iyo
iyx	f	iyx
izh	f	izh
izi	f	izi
izr	f	izr
izz	f	izz
jaa	f	jaa
jab	f	jab
jac	f	jac
jad	f	jad
jae	f	jae
jaf	f	jaf
jah	f	jah
jaj	f	jaj
jal	f	jal
jam	f	jam
jan	f	jan
jao	f	jao
jaq	f	jaq
jas	f	jas
jat	f	jat
jau	f	jau
jax	f	jax
jay	f	jay
jaz	f	jaz
jbj	f	jbj
jbk	f	jbk
jbn	f	jbn
jbo	f	jbo
jbr	f	jbr
jbt	f	jbt
jbu	f	jbu
jbw	f	jbw
jcs	f	jcs
jct	f	jct
jda	f	jda
jdg	f	jdg
jdt	f	jdt
jeb	f	jeb
jee	f	jee
jeg	f	jeg
jeh	f	jeh
jei	f	jei
jek	f	jek
jel	f	jel
jen	f	jen
jer	f	jer
jet	f	jet
jeu	f	jeu
jgb	f	jgb
jgk	f	jgk
jgo	f	jgo
jhi	f	jhi
jhs	f	jhs
jia	f	jia
jib	f	jib
jic	f	jic
jid	f	jid
jie	f	jie
jig	f	jig
jih	f	jih
jii	f	jii
jil	f	jil
jim	f	jim
jio	f	jio
jiq	f	jiq
jit	f	jit
jiu	f	jiu
jiv	f	jiv
jiy	f	jiy
jje	f	jje
jjr	f	jjr
jka	f	jka
jko	f	jko
jkr	f	jkr
jku	f	jku
jle	f	jle
jls	f	jls
jma	f	jma
jmb	f	jmb
jmc	f	jmc
jmd	f	jmd
jmi	f	jmi
jml	f	jml
jmn	f	jmn
jmr	f	jmr
jmw	f	jmw
jmx	f	jmx
jna	f	jna
jnd	f	jnd
jng	f	jng
jni	f	jni
jnj	f	jnj
jnl	f	jnl
jns	f	jns
job	f	job
jod	f	jod
jor	f	jor
jos	f	jos
jow	f	jow
jpr	f	jpr
jqr	f	jqr
jra	f	jra
jrr	f	jrr
jru	f	jru
jsl	f	jsl
jua	f	jua
jub	f	jub
juc	f	juc
jud	f	jud
juh	f	juh
jui	f	jui
juk	f	juk
jul	f	jul
jum	f	jum
jun	f	jun
juo	f	juo
jup	f	jup
jur	f	jur
jus	f	jus
jut	f	jut
juu	f	juu
juw	f	juw
juy	f	juy
jvd	f	jvd
jvn	f	jvn
jwi	f	jwi
jyy	f	jyy
kaa	f	kaa
kab	f	kab
kac	f	kac
kad	f	kad
kae	f	kae
kaf	f	kaf
kag	f	kag
kah	f	kah
kai	f	kai
kaj	f	kaj
kak	f	kak
kam	f	kam
kao	f	kao
kap	f	kap
kaq	f	kaq
kaw	f	kaw
kax	f	kax
kay	f	kay
kba	f	kba
kbb	f	kbb
kbc	f	kbc
kbd	f	kbd
kbe	f	kbe
kbh	f	kbh
kbi	f	kbi
kbj	f	kbj
kbk	f	kbk
kbm	f	kbm
kbn	f	kbn
kbo	f	kbo
kbp	f	kbp
kbq	f	kbq
kbr	f	kbr
kbs	f	kbs
kbt	f	kbt
kbu	f	kbu
kbv	f	kbv
kbw	f	kbw
kbx	f	kbx
kbz	f	kbz
kca	f	kca
kcb	f	kcb
kcc	f	kcc
kcd	f	kcd
kce	f	kce
kcf	f	kcf
kcg	f	kcg
kch	f	kch
kci	f	kci
kcj	f	kcj
kck	f	kck
kcl	f	kcl
kcm	f	kcm
kcn	t	kcn
kco	f	kco
kcp	f	kcp
kcq	f	kcq
kcr	f	kcr
kcs	f	kcs
kct	f	kct
kcu	f	kcu
kcv	f	kcv
kcw	f	kcw
kcx	f	kcx
kcy	f	kcy
kcz	f	kcz
kda	f	kda
kdc	f	kdc
kdd	f	kdd
kde	f	kde
kdf	f	kdf
kdg	f	kdg
kdh	f	kdh
kdi	f	kdi
kdj	f	kdj
kdk	f	kdk
kdl	f	kdl
kdm	f	kdm
kdn	f	kdn
kdp	f	kdp
kdq	f	kdq
kdr	f	kdr
kdt	f	kdt
kdu	f	kdu
kdv	f	kdv
kdw	f	kdw
kdx	f	kdx
kdy	f	kdy
kdz	f	kdz
kea	f	kea
keb	f	keb
kec	f	kec
ked	f	ked
kee	f	kee
kef	f	kef
keg	f	keg
keh	f	keh
kei	f	kei
kej	f	kej
kek	f	kek
kel	f	kel
kem	f	kem
ken	f	ken
keo	f	keo
kep	f	kep
keq	f	keq
ker	f	ker
kes	f	kes
ket	f	ket
keu	f	keu
kev	f	kev
kew	f	kew
kex	f	kex
key	f	key
kez	f	kez
kfa	f	kfa
kfb	f	kfb
kfc	f	kfc
kfd	f	kfd
kfe	f	kfe
kff	f	kff
kfg	f	kfg
kfh	f	kfh
kfi	f	kfi
kfj	f	kfj
kfk	f	kfk
kfl	f	kfl
kfn	f	kfn
kfo	f	kfo
kfp	f	kfp
kfq	f	kfq
kfr	f	kfr
kfs	f	kfs
kft	f	kft
kfu	f	kfu
kfv	f	kfv
kfw	f	kfw
kfx	f	kfx
kfy	f	kfy
kfz	f	kfz
kga	f	kga
kgb	f	kgb
kgd	f	kgd
kge	f	kge
kgf	f	kgf
kgg	f	kgg
kgi	f	kgi
kgj	f	kgj
kgk	f	kgk
kgl	f	kgl
kgm	f	kgm
kgn	f	kgn
kgo	f	kgo
kgp	f	kgp
kgq	f	kgq
kgr	f	kgr
kgs	f	kgs
kgt	f	kgt
kgu	f	kgu
kgv	f	kgv
kgw	f	kgw
kgx	f	kgx
kgy	f	kgy
kha	f	kha
khb	t	khb
khc	f	khc
khd	f	khd
khe	f	khe
khf	f	khf
khh	f	khh
khj	f	khj
khl	f	khl
khn	f	khn
kho	f	kho
khp	f	khp
khq	f	khq
khr	f	khr
khs	f	khs
kht	t	kht
khu	f	khu
khv	f	khv
khw	f	khw
khx	f	khx
khy	f	khy
khz	f	khz
kia	f	kia
kib	f	kib
kic	f	kic
kid	f	kid
kie	f	kie
kif	f	kif
kig	f	kig
kih	f	kih
kii	f	kii
kij	f	kij
kil	f	kil
kim	f	kim
kio	f	kio
kip	f	kip
kiq	f	kiq
kis	f	kis
kit	f	kit
kiv	f	kiv
kiw	f	kiw
kix	f	kix
kiy	f	kiy
kiz	f	kiz
kja	f	kja
kjb	f	kjb
kjc	f	kjc
kjd	f	kjd
kje	f	kje
kjg	f	kjg
kjh	f	kjh
kji	f	kji
kjj	t	kjj
kjk	f	kjk
kjl	f	kjl
kjm	f	kjm
kjn	f	kjn
kjo	f	kjo
kjp	f	kjp
kjq	f	kjq
kjr	f	kjr
kjs	f	kjs
kjt	f	kjt
kju	f	kju
kjx	f	kjx
kjy	f	kjy
kjz	f	kjz
kka	f	kka
kkb	f	kkb
kkc	f	kkc
kkd	f	kkd
kke	f	kke
kkf	f	kkf
kkg	f	kkg
kkh	f	kkh
kki	f	kki
kkj	f	kkj
kkk	f	kkk
kkl	f	kkl
kkm	f	kkm
kkn	f	kkn
kko	f	kko
kkp	f	kkp
kkq	f	kkq
kkr	f	kkr
kks	f	kks
kkt	f	kkt
kku	f	kku
kkv	f	kkv
kkw	f	kkw
kkx	f	kkx
kky	f	kky
kkz	f	kkz
kla	f	kla
klb	f	klb
klc	f	klc
kld	f	kld
kle	f	kle
klf	f	klf
klg	f	klg
klh	f	klh
kli	f	kli
klj	f	klj
klk	f	klk
kll	f	kll
klm	f	klm
kln	f	kln
klo	f	klo
klp	f	klp
klq	f	klq
klr	f	klr
kls	f	kls
klt	f	klt
klu	f	klu
klv	f	klv
klw	f	klw
klx	f	klx
kly	f	kly
klz	f	klz
kma	f	kma
kmb	f	kmb
kmc	f	kmc
kmd	f	kmd
kme	f	kme
kmf	f	kmf
kmg	f	kmg
kmh	f	kmh
kmi	f	kmi
kmj	f	kmj
kmk	f	kmk
kml	f	kml
kmm	f	kmm
kmn	f	kmn
kmo	f	kmo
kmp	f	kmp
kmq	f	kmq
kmr	t	kmr
kms	f	kms
kmt	f	kmt
kmu	f	kmu
kmv	f	kmv
kmw	f	kmw
kmx	f	kmx
kmy	f	kmy
kmz	f	kmz
kna	f	kna
knb	f	knb
knd	f	knd
kne	f	kne
knf	f	knf
kni	f	kni
knj	f	knj
knk	f	knk
knl	f	knl
knm	f	knm
kno	f	kno
knp	f	knp
knq	f	knq
knr	f	knr
kns	f	kns
knt	f	knt
knu	f	knu
knv	f	knv
knx	f	knx
kny	f	kny
knz	f	knz
koa	f	koa
koc	f	koc
kod	f	kod
koe	f	koe
kof	f	kof
kog	f	kog
koh	f	koh
koi	f	koi
kok	t	kok
kol	f	kol
koo	f	koo
kop	f	kop
koq	f	koq
kos	f	kos
kot	f	kot
kou	f	kou
kov	f	kov
kow	f	kow
koy	f	koy
koz	f	koz
kpa	f	kpa
kpb	f	kpb
kpc	f	kpc
kpd	f	kpd
kpe	f	kpe
kpf	f	kpf
kpg	f	kpg
kph	f	kph
kpi	f	kpi
kpj	f	kpj
kpk	f	kpk
kpl	f	kpl
kpm	f	kpm
kpn	f	kpn
kpo	f	kpo
kpp	f	kpp
kpq	f	kpq
kpr	f	kpr
kps	f	kps
kpt	f	kpt
kpu	f	kpu
kpv	f	kpv
kpw	f	kpw
kpx	f	kpx
kpy	f	kpy
kpz	f	kpz
kqa	f	kqa
kqb	f	kqb
kqc	f	kqc
kqd	f	kqd
kqe	f	kqe
kqf	f	kqf
kqg	f	kqg
kqh	f	kqh
kqi	f	kqi
kqj	f	kqj
kqk	f	kqk
kql	f	kql
kqm	f	kqm
kqn	f	kqn
kqo	f	kqo
kqp	f	kqp
kqq	f	kqq
kqr	f	kqr
kqs	f	kqs
kqt	f	kqt
kqu	f	kqu
kqv	f	kqv
kqw	f	kqw
kqx	f	kqx
kqy	f	kqy
kqz	f	kqz
kra	f	kra
krb	f	krb
krc	f	krc
krd	f	krd
kre	f	kre
krf	f	krf
krh	f	krh
kri	f	kri
krj	f	krj
krk	f	krk
krl	f	krl
krm	f	krm
krn	f	krn
krp	f	krp
krr	f	krr
krs	f	krs
kru	f	kru
krv	f	krv
krw	f	krw
krx	f	krx
kry	f	kry
krz	f	krz
ksa	f	ksa
ksb	f	ksb
ksc	f	ksc
ksd	f	ksd
kse	f	kse
ksf	f	ksf
ksg	f	ksg
ksi	f	ksi
ksj	f	ksj
ksk	f	ksk
ksl	f	ksl
ksm	f	ksm
ksn	f	ksn
kso	f	kso
ksp	f	ksp
ksq	f	ksq
ksr	f	ksr
kss	f	kss
kst	f	kst
ksu	f	ksu
ksv	f	ksv
ksw	f	ksw
ksx	f	ksx
ksy	f	ksy
ksz	f	ksz
kta	f	kta
ktb	f	ktb
ktc	f	ktc
ktd	f	ktd
ktf	f	ktf
ktg	f	ktg
kth	f	kth
kti	f	kti
ktj	f	ktj
ktk	f	ktk
ktl	f	ktl
ktm	f	ktm
ktn	f	ktn
kto	f	kto
ktp	f	ktp
ktq	f	ktq
ktr	f	ktr
kts	f	kts
ktt	f	ktt
ktu	f	ktu
ktv	f	ktv
ktw	f	ktw
ktx	f	ktx
kty	f	kty
ktz	f	ktz
kub	f	kub
kuc	f	kuc
kud	f	kud
kue	f	kue
kuf	f	kuf
kug	f	kug
kuh	f	kuh
kui	f	kui
kuj	f	kuj
kuk	f	kuk
kul	f	kul
kum	f	kum
kun	f	kun
kuo	f	kuo
kup	f	kup
kuq	f	kuq
kus	f	kus
kut	f	kut
kuu	f	kuu
kuv	f	kuv
kuw	f	kuw
kux	f	kux
kuy	f	kuy
kuz	f	kuz
kva	f	kva
kvb	f	kvb
kvc	f	kvc
kvd	f	kvd
kve	f	kve
kvf	f	kvf
kvg	f	kvg
kvh	f	kvh
kvi	f	kvi
kvj	f	kvj
kvk	f	kvk
kvl	f	kvl
kvm	f	kvm
kvn	f	kvn
kvo	f	kvo
kvp	f	kvp
kvq	f	kvq
kvr	f	kvr
kvt	f	kvt
kvu	f	kvu
kvv	f	kvv
kvw	f	kvw
kvx	f	kvx
kvy	f	kvy
kvz	f	kvz
kwa	f	kwa
kwb	f	kwb
kwc	f	kwc
kwd	f	kwd
kwe	f	kwe
kwf	f	kwf
kwg	f	kwg
kwh	f	kwh
kwi	f	kwi
kwj	f	kwj
kwk	f	kwk
kwl	f	kwl
kwm	f	kwm
kwn	f	kwn
kwo	f	kwo
kwp	f	kwp
kwq	f	kwq
kwr	f	kwr
kws	f	kws
kwt	f	kwt
kwu	f	kwu
kwv	f	kwv
kww	f	kww
kwx	f	kwx
kwz	f	kwz
kxa	f	kxa
kxb	f	kxb
kxc	f	kxc
kxd	f	kxd
kxe	f	kxe
kxf	f	kxf
kxh	f	kxh
kxi	f	kxi
kxj	f	kxj
kxk	f	kxk
kxl	f	kxl
kxm	f	kxm
kxn	f	kxn
kxo	f	kxo
kxp	f	kxp
kxq	f	kxq
kxr	f	kxr
kxs	f	kxs
kxt	f	kxt
kxu	f	kxu
kxv	f	kxv
kxw	f	kxw
kxx	f	kxx
kxy	f	kxy
kxz	f	kxz
kya	f	kya
kyb	f	kyb
kyc	f	kyc
kyd	f	kyd
kye	f	kye
kyf	f	kyf
kyg	f	kyg
kyh	f	kyh
kyi	f	kyi
kyj	f	kyj
kyk	f	kyk
kyl	f	kyl
kym	f	kym
kyn	f	kyn
kyo	f	kyo
kyp	f	kyp
kyq	f	kyq
kyr	f	kyr
kys	f	kys
kyt	f	kyt
kyu	f	kyu
kyv	f	kyv
kyw	f	kyw
kyx	f	kyx
kyy	f	kyy
kyz	f	kyz
kza	f	kza
kzb	f	kzb
kzc	f	kzc
kzd	f	kzd
kze	f	kze
kzf	f	kzf
kzg	f	kzg
kzh	f	kzh
kzi	f	kzi
kzj	f	kzj
kzk	f	kzk
kzl	f	kzl
kzm	f	kzm
kzn	f	kzn
kzo	f	kzo
kzp	f	kzp
kzq	f	kzq
kzr	f	kzr
kzs	f	kzs
kzt	f	kzt
kzu	f	kzu
kzv	f	kzv
kzw	f	kzw
kzx	f	kzx
kzy	f	kzy
kzz	f	kzz
laa	f	laa
lab	f	lab
lac	f	lac
lad	f	lad
lae	f	lae
laf	f	laf
lag	f	lag
lah	f	lah
lai	f	lai
laj	f	laj
lak	f	lak
lam	f	lam
lan	f	lan
lap	f	lap
laq	f	laq
lar	f	lar
las	f	las
lau	f	lau
law	f	law
lax	f	lax
lay	f	lay
laz	f	laz
lbb	f	lbb
lbc	f	lbc
lbe	f	lbe
lbf	f	lbf
lbg	f	lbg
lbi	f	lbi
lbj	f	lbj
lbk	f	lbk
lbl	f	lbl
lbm	f	lbm
lbn	f	lbn
lbo	f	lbo
lbq	f	lbq
lbr	f	lbr
lbs	f	lbs
lbt	f	lbt
lbu	f	lbu
lbv	f	lbv
lbw	f	lbw
lbx	f	lbx
lby	f	lby
lbz	f	lbz
lcc	f	lcc
lcd	f	lcd
lce	f	lce
lcf	f	lcf
lch	f	lch
lcl	f	lcl
lcm	f	lcm
lcp	f	lcp
lcq	f	lcq
lcs	f	lcs
lda	f	lda
ldb	f	ldb
ldd	f	ldd
ldg	f	ldg
ldh	f	ldh
ldj	f	ldj
ldk	f	ldk
ldl	f	ldl
ldm	f	ldm
ldn	f	ldn
ldo	f	ldo
ldp	f	ldp
ldq	f	ldq
lea	f	lea
leb	f	leb
lec	f	lec
led	f	led
lee	f	lee
lef	f	lef
leh	f	leh
lei	f	lei
lej	f	lej
lek	f	lek
lel	f	lel
lem	f	lem
len	f	len
leo	f	leo
lep	f	lep
leq	f	leq
ler	f	ler
les	f	les
let	f	let
leu	f	leu
lev	f	lev
lew	f	lew
lex	f	lex
ley	f	ley
lez	t	lez
lfa	f	lfa
lfn	f	lfn
lga	f	lga
lgb	f	lgb
lgg	f	lgg
lgh	f	lgh
lgi	f	lgi
lgk	f	lgk
lgl	f	lgl
lgm	f	lgm
lgn	f	lgn
lgq	f	lgq
lgr	f	lgr
lgt	f	lgt
lgu	f	lgu
lgz	f	lgz
lha	f	lha
lhh	f	lhh
lhi	f	lhi
lhl	f	lhl
lhn	f	lhn
lhp	f	lhp
lhs	f	lhs
lht	f	lht
lhu	f	lhu
lia	f	lia
lib	f	lib
lic	f	lic
lid	f	lid
lie	f	lie
lif	f	lif
lig	f	lig
lih	f	lih
lii	f	lii
lij	f	lij
lik	f	lik
lil	f	lil
lio	f	lio
lip	f	lip
liq	f	liq
lir	f	lir
lis	f	lis
liu	f	liu
liv	t	liv
liw	f	liw
lix	f	lix
liy	f	liy
liz	f	liz
lja	f	lja
lje	f	lje
lji	f	lji
ljl	f	ljl
ljp	f	ljp
ljw	f	ljw
ljx	f	ljx
lka	f	lka
lkb	f	lkb
lkc	f	lkc
lkd	f	lkd
lke	f	lke
lkh	f	lkh
lki	t	lki
lkj	f	lkj
lkl	f	lkl
lkm	f	lkm
lkn	f	lkn
lko	f	lko
lkr	f	lkr
lks	f	lks
lkt	f	lkt
lku	f	lku
lky	f	lky
lla	f	lla
llb	f	llb
llc	f	llc
lld	f	lld
lle	f	lle
llf	f	llf
llg	f	llg
llh	f	llh
lli	f	lli
llj	f	llj
llk	f	llk
lll	f	lll
llm	f	llm
lln	f	lln
llo	f	llo
llp	f	llp
llq	f	llq
lls	f	lls
llu	f	llu
llx	f	llx
lma	f	lma
lmb	f	lmb
lmc	f	lmc
lmd	f	lmd
lme	f	lme
lmf	f	lmf
lmg	f	lmg
lmh	f	lmh
lmi	f	lmi
lmj	f	lmj
lmk	f	lmk
lml	f	lml
lmn	f	lmn
lmo	f	lmo
lmp	f	lmp
lmq	f	lmq
lmr	f	lmr
lmu	f	lmu
lmv	f	lmv
lmw	f	lmw
lmx	f	lmx
lmy	f	lmy
lmz	f	lmz
lna	f	lna
lnb	f	lnb
lnd	f	lnd
lnh	f	lnh
lni	f	lni
lnj	f	lnj
lnl	f	lnl
lnm	f	lnm
lnn	f	lnn
lno	f	lno
lns	f	lns
lnu	f	lnu
lnw	f	lnw
loa	f	loa
lob	f	lob
loc	f	loc
lod	f	lod
loe	f	loe
lof	f	lof
log	f	log
loh	f	loh
loi	f	loi
loj	f	loj
lok	f	lok
lol	f	lol
lom	f	lom
lon	f	lon
loo	f	loo
lop	f	lop
loq	f	loq
lor	f	lor
los	f	los
lot	f	lot
lou	f	lou
lov	f	lov
low	f	low
lox	f	lox
loz	f	loz
lpa	f	lpa
lpe	f	lpe
lpn	f	lpn
lpo	f	lpo
lpx	f	lpx
lra	f	lra
lrc	f	lrc
lre	f	lre
lrg	f	lrg
lri	f	lri
lrk	f	lrk
lrl	f	lrl
lrm	f	lrm
lrn	f	lrn
lro	f	lro
lrr	f	lrr
lrt	f	lrt
lrv	f	lrv
lrz	f	lrz
lsa	f	lsa
lsd	f	lsd
lse	f	lse
lsh	f	lsh
lsi	f	lsi
lsl	f	lsl
lsm	f	lsm
lso	f	lso
lsp	f	lsp
lsr	f	lsr
lss	f	lss
lst	f	lst
lsy	f	lsy
ltc	f	ltc
ltg	f	ltg
lti	f	lti
ltn	f	ltn
lto	f	lto
lts	f	lts
ltu	f	ltu
lua	f	lua
luc	f	luc
lud	f	lud
lue	f	lue
luf	f	luf
lui	t	lui
luj	f	luj
luk	f	luk
lul	f	lul
lum	f	lum
lun	f	lun
luo	f	luo
lup	f	lup
luq	f	luq
lur	f	lur
lus	f	lus
lut	f	lut
luu	f	luu
luv	f	luv
luy	f	luy
luz	f	luz
lva	f	lva
lvi	f	lvi
lvk	f	lvk
lvu	f	lvu
lwa	f	lwa
lwe	f	lwe
lwg	f	lwg
lwh	f	lwh
lwl	f	lwl
lwm	f	lwm
lwo	f	lwo
lws	f	lws
lwt	f	lwt
lwu	f	lwu
lww	f	lww
lya	f	lya
lyg	f	lyg
lyn	f	lyn
lzh	f	lzh
lzl	f	lzl
lzn	f	lzn
lzz	t	lzz
maa	f	maa
mab	f	mab
mad	f	mad
mae	f	mae
maf	f	maf
mag	f	mag
mai	f	mai
maj	f	maj
mak	f	mak
mam	f	mam
man	f	man
maq	f	maq
mas	f	mas
mat	f	mat
mau	f	mau
mav	f	mav
maw	f	maw
max	f	max
maz	f	maz
mba	f	mba
mbb	f	mbb
mbc	f	mbc
mbd	f	mbd
mbe	f	mbe
mbf	f	mbf
mbh	f	mbh
mbi	f	mbi
mbj	f	mbj
mbk	f	mbk
mbl	f	mbl
mbm	f	mbm
mbn	f	mbn
mbo	f	mbo
mbp	f	mbp
mbq	f	mbq
mbr	f	mbr
mbs	f	mbs
mbt	f	mbt
mbu	f	mbu
mbv	f	mbv
mbw	f	mbw
mbx	f	mbx
mby	f	mby
mbz	f	mbz
mca	f	mca
mcb	f	mcb
mcc	f	mcc
mcd	f	mcd
mce	f	mce
mcf	f	mcf
mcg	f	mcg
mch	f	mch
mci	f	mci
mcj	f	mcj
mck	f	mck
mcl	f	mcl
mcm	f	mcm
mcn	f	mcn
mco	f	mco
mcp	f	mcp
mcq	f	mcq
mcr	f	mcr
mcs	f	mcs
mcu	f	mcu
mcv	f	mcv
mcw	f	mcw
mcx	f	mcx
mcy	f	mcy
mcz	f	mcz
mda	f	mda
mdb	f	mdb
mdc	f	mdc
mdd	f	mdd
mde	f	mde
mdf	f	mdf
mdg	f	mdg
mdh	f	mdh
mdi	f	mdi
mdj	f	mdj
mdk	f	mdk
mdl	f	mdl
mdm	f	mdm
mdn	f	mdn
mdp	f	mdp
mdq	f	mdq
mdr	f	mdr
mds	f	mds
mdt	f	mdt
mdu	f	mdu
mdv	f	mdv
mdw	f	mdw
mdx	f	mdx
mdy	f	mdy
mdz	f	mdz
mea	f	mea
meb	f	meb
mec	f	mec
med	f	med
mee	f	mee
mef	f	mef
meg	f	meg
meh	f	meh
mei	f	mei
mej	f	mej
mek	f	mek
mel	f	mel
mem	f	mem
men	f	men
meo	f	meo
mep	f	mep
meq	f	meq
mer	f	mer
mes	f	mes
met	f	met
meu	f	meu
mev	f	mev
mew	f	mew
mey	f	mey
mez	f	mez
mfa	f	mfa
mfb	f	mfb
mfc	f	mfc
mfd	f	mfd
mfe	f	mfe
mff	f	mff
mfg	f	mfg
mfh	f	mfh
mfi	f	mfi
mfj	f	mfj
mfk	f	mfk
mfl	f	mfl
mfm	f	mfm
mfn	f	mfn
mfo	f	mfo
mfp	f	mfp
mfq	f	mfq
mfr	f	mfr
mfs	f	mfs
mft	f	mft
mfu	f	mfu
mfv	f	mfv
mfw	f	mfw
mfx	f	mfx
mfy	f	mfy
mfz	f	mfz
mga	t	mga
mgb	f	mgb
mgc	f	mgc
mgd	f	mgd
mge	f	mge
mgf	f	mgf
mgg	f	mgg
mgh	f	mgh
mgi	f	mgi
mgj	f	mgj
mgk	f	mgk
mgl	f	mgl
mgm	f	mgm
mgn	f	mgn
mgo	f	mgo
mgp	f	mgp
mgq	f	mgq
mgr	f	mgr
mgs	f	mgs
mgt	f	mgt
mgu	f	mgu
mgv	f	mgv
mgw	f	mgw
mgy	f	mgy
mgz	f	mgz
mha	f	mha
mhb	f	mhb
mhc	f	mhc
mhd	f	mhd
mhe	f	mhe
mhf	f	mhf
mhg	f	mhg
mhi	f	mhi
mhj	f	mhj
mhk	f	mhk
mhl	f	mhl
mhm	f	mhm
mhn	f	mhn
mho	f	mho
mhp	f	mhp
mhq	f	mhq
mhs	f	mhs
mht	f	mht
mhu	f	mhu
mhw	f	mhw
mhx	f	mhx
mhy	f	mhy
mhz	f	mhz
mia	f	mia
mib	f	mib
mic	f	mic
mid	f	mid
mie	f	mie
mif	f	mif
mig	f	mig
mih	f	mih
mii	f	mii
mij	f	mij
mik	f	mik
mil	f	mil
mim	f	mim
min	f	min
mio	f	mio
mip	f	mip
miq	t	miq
mir	f	mir
mit	f	mit
miu	f	miu
miw	f	miw
mix	f	mix
miy	f	miy
miz	f	miz
mjb	f	mjb
mjc	f	mjc
mjd	f	mjd
mje	f	mje
mjg	f	mjg
mji	f	mji
mjj	f	mjj
mjk	f	mjk
mjl	f	mjl
mjm	f	mjm
mjn	f	mjn
mjo	f	mjo
mjp	f	mjp
mjq	f	mjq
mjr	f	mjr
mjs	f	mjs
mjt	f	mjt
mju	f	mju
mjv	f	mjv
mjw	f	mjw
mjx	f	mjx
mjy	f	mjy
mjz	f	mjz
mka	f	mka
mkb	f	mkb
mkc	f	mkc
mke	f	mke
mkf	f	mkf
mkg	f	mkg
mki	f	mki
mkj	f	mkj
mkk	f	mkk
mkl	f	mkl
mkm	f	mkm
mkn	f	mkn
mko	f	mko
mkp	f	mkp
mkq	f	mkq
mkr	f	mkr
mks	f	mks
mkt	f	mkt
mku	f	mku
mkv	f	mkv
mkx	f	mkx
mky	f	mky
mkz	f	mkz
mla	f	mla
mlb	f	mlb
mlc	f	mlc
mle	f	mle
mlf	f	mlf
mlh	f	mlh
mli	f	mli
mlj	f	mlj
mlk	f	mlk
mll	f	mll
mlm	f	mlm
mln	f	mln
mlo	f	mlo
mlp	f	mlp
mlq	f	mlq
mlr	f	mlr
mls	f	mls
mlu	f	mlu
mlv	f	mlv
mlw	f	mlw
mlx	f	mlx
mlz	f	mlz
mma	f	mma
mmb	f	mmb
mmc	f	mmc
mmd	f	mmd
mme	f	mme
mmf	f	mmf
mmg	f	mmg
mmh	f	mmh
mmi	f	mmi
mmj	f	mmj
mmk	f	mmk
mml	f	mml
mmm	f	mmm
mmn	f	mmn
mmo	f	mmo
mmp	f	mmp
mmq	f	mmq
mmr	f	mmr
mmt	f	mmt
mmu	f	mmu
mmv	f	mmv
mmw	f	mmw
mmx	f	mmx
mmy	f	mmy
mmz	f	mmz
mna	f	mna
mnb	f	mnb
mnc	f	mnc
mnd	f	mnd
mne	f	mne
mnf	f	mnf
mng	f	mng
mnh	f	mnh
mni	f	mni
mnj	f	mnj
mnk	f	mnk
mnl	f	mnl
mnm	f	mnm
mnn	f	mnn
mnp	f	mnp
mnq	f	mnq
mnr	f	mnr
mns	f	mns
mnt	f	mnt
mnu	f	mnu
mnv	f	mnv
mnw	f	mnw
mnx	f	mnx
mny	f	mny
mnz	f	mnz
moa	f	moa
moc	f	moc
mod	f	mod
moe	t	moe
mog	f	mog
moh	f	moh
moi	f	moi
moj	f	moj
mok	f	mok
mom	f	mom
moo	f	moo
mop	f	mop
moq	f	moq
mor	f	mor
mos	f	mos
mot	f	mot
mou	f	mou
mov	f	mov
mow	f	mow
mox	f	mox
moy	f	moy
moz	f	moz
mpa	f	mpa
mpb	f	mpb
mpc	f	mpc
mpd	f	mpd
mpe	f	mpe
mpg	f	mpg
mph	f	mph
mpi	f	mpi
mpj	f	mpj
mpk	f	mpk
mpl	f	mpl
mpm	f	mpm
mpn	f	mpn
mpo	f	mpo
mpp	f	mpp
mpq	f	mpq
mpr	f	mpr
mps	f	mps
mpt	f	mpt
mpu	f	mpu
mpv	f	mpv
mpw	f	mpw
mpx	f	mpx
mpy	f	mpy
mpz	f	mpz
mqa	f	mqa
mqb	f	mqb
mqc	f	mqc
mqe	f	mqe
mqf	f	mqf
mqg	f	mqg
mqh	f	mqh
mqi	f	mqi
mqj	f	mqj
mqk	f	mqk
mql	f	mql
mqm	f	mqm
mqn	f	mqn
mqo	f	mqo
mqp	f	mqp
mqq	f	mqq
mqr	f	mqr
mqs	f	mqs
mqt	f	mqt
mqu	f	mqu
mqv	f	mqv
mqw	f	mqw
mqx	f	mqx
mqy	f	mqy
mqz	f	mqz
mra	f	mra
mrb	f	mrb
mrc	f	mrc
mrd	f	mrd
mre	f	mre
mrf	f	mrf
mrg	f	mrg
mrh	f	mrh
mrj	f	mrj
mrk	f	mrk
mrl	f	mrl
mrm	f	mrm
mrn	f	mrn
mro	f	mro
mrp	f	mrp
mrq	f	mrq
mrr	f	mrr
mrs	f	mrs
mrt	f	mrt
mru	f	mru
mrv	f	mrv
mrw	f	mrw
mrx	f	mrx
mry	f	mry
mrz	f	mrz
msb	f	msb
msc	f	msc
msd	f	msd
mse	f	mse
msf	f	msf
msg	f	msg
msi	f	msi
msj	f	msj
msk	f	msk
msl	f	msl
msm	f	msm
msn	f	msn
mso	f	mso
msp	f	msp
msq	f	msq
msr	f	msr
mss	f	mss
msu	f	msu
msv	f	msv
msw	f	msw
msx	f	msx
msy	f	msy
msz	f	msz
mta	f	mta
mtb	f	mtb
mtc	f	mtc
mtd	f	mtd
mte	f	mte
mtf	f	mtf
mtg	f	mtg
mth	f	mth
mti	f	mti
mtj	f	mtj
mtk	f	mtk
mtl	f	mtl
mtm	f	mtm
mtn	f	mtn
mto	f	mto
mtp	f	mtp
mtq	f	mtq
mtr	f	mtr
mts	f	mts
mtt	f	mtt
mtu	f	mtu
mtv	f	mtv
mtw	f	mtw
mtx	f	mtx
mty	f	mty
mua	f	mua
mub	f	mub
muc	f	muc
mud	f	mud
mue	f	mue
mug	f	mug
muh	f	muh
mui	f	mui
muj	f	muj
mul	f	mul
mum	f	mum
muo	f	muo
mup	f	mup
muq	f	muq
mur	f	mur
mus	f	mus
mut	f	mut
muu	f	muu
muv	f	muv
mux	f	mux
muy	f	muy
muz	f	muz
mva	f	mva
mvb	f	mvb
mvd	f	mvd
mvg	f	mvg
mvh	f	mvh
mvi	f	mvi
mvk	f	mvk
mvl	f	mvl
mvm	f	mvm
mvn	f	mvn
mvo	f	mvo
mvp	f	mvp
mvq	f	mvq
mvr	f	mvr
mvs	f	mvs
mvt	f	mvt
mvu	f	mvu
mvv	f	mvv
mvw	f	mvw
mvx	f	mvx
mvy	f	mvy
mvz	f	mvz
mwa	f	mwa
mwb	f	mwb
mwc	f	mwc
mwe	f	mwe
mwf	f	mwf
mwg	f	mwg
mwh	f	mwh
mwi	f	mwi
mwk	f	mwk
mwl	f	mwl
mwm	f	mwm
mwn	f	mwn
mwo	f	mwo
mwp	f	mwp
mwq	f	mwq
mwr	f	mwr
mws	f	mws
mwt	f	mwt
mwu	f	mwu
mwv	f	mwv
mww	f	mww
mwz	f	mwz
mxa	f	mxa
mxb	f	mxb
mxd	f	mxd
mxe	f	mxe
mxf	f	mxf
mxg	f	mxg
mxh	f	mxh
mxi	f	mxi
mxj	f	mxj
mxk	f	mxk
mxl	f	mxl
mxm	f	mxm
mxn	f	mxn
mxo	f	mxo
mxp	f	mxp
mxq	f	mxq
mxr	f	mxr
mxs	f	mxs
mxt	f	mxt
mxu	f	mxu
mxv	f	mxv
mxw	f	mxw
mxx	f	mxx
mxy	f	mxy
mxz	f	mxz
myb	f	myb
myc	f	myc
mye	f	mye
myf	f	myf
myg	f	myg
myh	f	myh
myj	f	myj
myk	f	myk
myl	f	myl
mym	f	mym
myo	f	myo
myp	f	myp
myr	f	myr
mys	f	mys
myu	f	myu
myv	f	myv
myw	f	myw
myx	f	myx
myy	f	myy
myz	f	myz
mza	f	mza
mzb	f	mzb
mzc	f	mzc
mzd	f	mzd
mze	f	mze
mzg	f	mzg
mzh	f	mzh
mzi	f	mzi
mzj	f	mzj
mzk	f	mzk
mzl	f	mzl
mzm	f	mzm
mzn	f	mzn
mzo	f	mzo
mzp	f	mzp
mzq	f	mzq
mzr	f	mzr
mzs	f	mzs
mzt	f	mzt
mzu	f	mzu
mzv	f	mzv
mzw	f	mzw
mzx	f	mzx
mzy	f	mzy
mzz	f	mzz
naa	f	naa
nab	f	nab
nac	f	nac
nae	f	nae
naf	f	naf
nag	f	nag
nah	f	nah
naj	f	naj
nak	f	nak
nal	f	nal
nam	f	nam
nan	f	nan
nao	f	nao
nap	f	nap
naq	f	naq
nar	f	nar
nas	f	nas
nat	f	nat
naw	f	naw
nax	f	nax
nay	f	nay
naz	f	naz
nba	f	nba
nbb	f	nbb
nbc	f	nbc
nbd	f	nbd
nbe	f	nbe
nbg	f	nbg
nbh	f	nbh
nbi	f	nbi
nbj	f	nbj
nbk	f	nbk
nbm	f	nbm
nbn	f	nbn
nbo	f	nbo
nbp	f	nbp
nbq	f	nbq
nbr	f	nbr
nbs	f	nbs
nbt	f	nbt
nbu	f	nbu
nbv	f	nbv
nbw	f	nbw
nby	f	nby
nca	f	nca
ncb	f	ncb
ncc	f	ncc
ncd	f	ncd
nce	f	nce
ncf	f	ncf
ncg	f	ncg
nch	f	nch
nci	t	nci
ncj	f	ncj
nck	f	nck
ncl	f	ncl
ncm	f	ncm
ncn	f	ncn
nco	f	nco
ncr	f	ncr
ncs	f	ncs
nct	f	nct
ncu	f	ncu
ncx	f	ncx
ncz	f	ncz
nda	f	nda
ndb	f	ndb
ndc	f	ndc
ndd	f	ndd
ndf	f	ndf
ndg	f	ndg
ndh	f	ndh
ndi	f	ndi
ndj	f	ndj
ndk	f	ndk
ndl	f	ndl
ndm	f	ndm
ndn	f	ndn
ndp	f	ndp
ndq	f	ndq
ndr	f	ndr
nds	f	nds
ndt	f	ndt
ndu	f	ndu
ndv	f	ndv
ndw	f	ndw
ndx	f	ndx
ndy	f	ndy
ndz	f	ndz
nea	f	nea
neb	f	neb
nec	f	nec
ned	f	ned
nee	f	nee
nef	f	nef
neg	f	neg
neh	f	neh
nej	f	nej
nek	f	nek
nem	f	nem
nen	f	nen
neo	f	neo
neq	f	neq
ner	f	ner
nes	f	nes
net	f	net
neu	f	neu
nev	f	nev
new	f	new
nex	f	nex
ney	f	ney
nez	f	nez
nfa	f	nfa
nfd	f	nfd
nfl	f	nfl
nfr	f	nfr
nfu	f	nfu
nga	f	nga
ngb	f	ngb
ngc	f	ngc
ngd	f	ngd
nge	f	nge
ngg	f	ngg
ngh	f	ngh
ngi	f	ngi
ngj	f	ngj
ngk	f	ngk
ngl	f	ngl
ngm	f	ngm
ngn	f	ngn
ngo	f	ngo
ngp	f	ngp
ngq	f	ngq
ngr	f	ngr
ngs	f	ngs
ngt	f	ngt
ngu	f	ngu
ngv	f	ngv
ngw	f	ngw
ngx	f	ngx
ngy	f	ngy
ngz	f	ngz
nha	f	nha
nhb	f	nhb
nhc	f	nhc
nhd	f	nhd
nhe	f	nhe
nhf	f	nhf
nhg	f	nhg
nhh	f	nhh
nhi	f	nhi
nhk	f	nhk
nhm	f	nhm
nhn	f	nhn
nho	f	nho
nhp	f	nhp
nhq	f	nhq
nhr	f	nhr
nht	f	nht
nhu	f	nhu
nhv	f	nhv
nhw	f	nhw
nhx	f	nhx
nhy	f	nhy
nhz	f	nhz
nia	f	nia
nib	f	nib
nid	f	nid
nie	f	nie
nif	f	nif
nig	f	nig
nih	f	nih
nii	f	nii
nij	f	nij
nik	f	nik
nil	f	nil
nim	f	nim
nin	f	nin
nio	f	nio
niq	f	niq
nir	f	nir
nis	f	nis
nit	f	nit
niu	f	niu
niv	f	niv
niw	f	niw
nix	f	nix
niy	f	niy
niz	f	niz
nja	f	nja
njb	f	njb
njh	f	njh
nji	f	nji
njj	f	njj
njl	f	njl
njm	f	njm
njn	f	njn
njo	f	njo
njr	f	njr
njs	f	njs
njt	f	njt
nju	f	nju
njx	f	njx
njy	f	njy
njz	f	njz
nka	f	nka
nkb	f	nkb
nkc	f	nkc
nkd	f	nkd
nke	f	nke
nkf	f	nkf
nkg	f	nkg
nkh	f	nkh
nki	f	nki
nkj	f	nkj
nkk	f	nkk
nkm	f	nkm
nkn	f	nkn
nko	f	nko
nkp	f	nkp
nkq	f	nkq
nkr	f	nkr
nks	f	nks
nkt	f	nkt
nku	f	nku
nkw	f	nkw
nkx	f	nkx
nkz	f	nkz
nla	f	nla
nlc	f	nlc
nle	f	nle
nlg	f	nlg
nli	f	nli
nlj	f	nlj
nlk	f	nlk
nll	f	nll
nlm	f	nlm
nlo	f	nlo
nlq	f	nlq
nlu	f	nlu
nlv	f	nlv
nlw	f	nlw
nlx	f	nlx
nly	f	nly
nlz	f	nlz
nma	f	nma
nmb	f	nmb
nmc	f	nmc
nmd	f	nmd
nme	f	nme
nmf	f	nmf
nmg	f	nmg
nmh	f	nmh
nmi	f	nmi
nmj	f	nmj
nmk	f	nmk
nml	f	nml
nmm	f	nmm
nmn	f	nmn
nmo	f	nmo
nmp	f	nmp
nmq	f	nmq
nmr	f	nmr
nms	f	nms
nmt	f	nmt
nmu	f	nmu
nmv	f	nmv
nmw	f	nmw
nmy	f	nmy
nmz	f	nmz
nna	f	nna
nnb	f	nnb
nnc	f	nnc
nnd	f	nnd
nne	f	nne
nnf	f	nnf
nng	f	nng
nnh	f	nnh
nni	f	nni
nnj	f	nnj
nnk	f	nnk
nnl	f	nnl
nnm	f	nnm
nnn	f	nnn
nnp	f	nnp
nnq	f	nnq
nnr	f	nnr
nnt	f	nnt
nnu	f	nnu
nnv	f	nnv
nnw	f	nnw
nnx	f	nnx
nny	f	nny
nnz	f	nnz
noa	f	noa
noc	f	noc
nod	t	nod
noe	f	noe
nof	f	nof
nog	f	nog
noh	f	noh
noi	f	noi
noj	f	noj
nok	f	nok
nol	f	nol
nom	f	nom
non	f	non
nop	f	nop
noq	f	noq
nos	f	nos
not	f	not
nou	f	nou
nov	f	nov
now	f	now
noy	f	noy
noz	f	noz
npa	f	npa
npb	f	npb
npg	f	npg
nph	f	nph
npl	f	npl
npn	f	npn
npo	f	npo
nps	f	nps
npu	f	npu
npy	f	npy
nqg	f	nqg
nqk	f	nqk
nql	f	nql
nqm	f	nqm
nqn	f	nqn
nqo	f	nqo
nqq	f	nqq
nqy	f	nqy
nra	f	nra
nrb	f	nrb
nrc	f	nrc
nre	f	nre
nrf	f	nrf
nrg	f	nrg
nri	f	nri
nrk	f	nrk
nrl	f	nrl
nrm	f	nrm
nrn	f	nrn
nrp	f	nrp
nrr	f	nrr
nrt	f	nrt
nru	f	nru
nrx	f	nrx
nrz	f	nrz
nsa	f	nsa
nsb	f	nsb
nsc	f	nsc
nsd	f	nsd
nse	f	nse
nsg	f	nsg
nsh	f	nsh
nsi	f	nsi
nsk	f	nsk
nsl	f	nsl
nsm	f	nsm
nsn	f	nsn
nso	f	nso
nsp	f	nsp
nsq	f	nsq
nsr	f	nsr
nss	f	nss
nst	f	nst
nsu	f	nsu
nsv	f	nsv
nsw	f	nsw
nsx	f	nsx
nsy	f	nsy
nsz	f	nsz
ntd	f	ntd
nte	f	nte
ntg	f	ntg
nti	f	nti
ntj	f	ntj
ntk	f	ntk
ntm	f	ntm
nto	f	nto
ntp	f	ntp
ntr	f	ntr
nts	f	nts
ntu	f	ntu
ntw	f	ntw
ntx	f	ntx
nty	f	nty
nua	f	nua
nuc	f	nuc
nud	f	nud
nue	f	nue
nuf	f	nuf
nug	f	nug
nuh	f	nuh
nui	f	nui
nuj	f	nuj
nuk	f	nuk
nul	f	nul
num	f	num
nun	f	nun
nuo	f	nuo
nup	t	nup
nuq	f	nuq
nur	f	nur
nus	f	nus
nut	f	nut
nuu	f	nuu
nuv	f	nuv
nuw	f	nuw
nux	f	nux
nuy	f	nuy
nuz	f	nuz
nvh	f	nvh
nvm	f	nvm
nvo	f	nvo
nwa	f	nwa
nwb	f	nwb
nwc	f	nwc
nwe	f	nwe
nwi	f	nwi
nwm	f	nwm
nwo	f	nwo
nwr	f	nwr
nwx	f	nwx
nwy	f	nwy
nxa	f	nxa
nxd	f	nxd
nxe	f	nxe
nxg	f	nxg
nxi	f	nxi
nxl	f	nxl
nxm	f	nxm
nxn	f	nxn
nxo	f	nxo
nxq	f	nxq
nxr	f	nxr
nxu	f	nxu
nxx	f	nxx
nyb	f	nyb
nyc	f	nyc
nyd	f	nyd
nye	f	nye
nyf	f	nyf
nyg	f	nyg
nyh	f	nyh
nyi	f	nyi
nyj	f	nyj
nyk	f	nyk
nyl	f	nyl
nym	f	nym
nyn	f	nyn
nyo	f	nyo
nyp	f	nyp
nys	f	nys
nyt	f	nyt
nyu	f	nyu
nyv	f	nyv
nyw	f	nyw
nyx	f	nyx
nyy	f	nyy
nza	f	nza
nzb	f	nzb
nzd	t	nzd
nzi	f	nzi
nzk	f	nzk
nzm	f	nzm
nzs	f	nzs
nzu	f	nzu
nzy	f	nzy
nzz	f	nzz
oaa	f	oaa
oac	f	oac
oav	f	oav
obi	f	obi
obk	f	obk
obl	f	obl
obm	f	obm
obo	f	obo
obr	f	obr
obt	f	obt
obu	f	obu
oca	f	oca
och	f	och
oco	f	oco
ocu	f	ocu
oda	f	oda
odk	f	odk
odt	t	odt
odu	f	odu
ofo	f	ofo
ofs	t	ofs
ofu	f	ofu
ogb	f	ogb
ogc	f	ogc
oge	t	oge
ogg	f	ogg
ogo	f	ogo
ogu	f	ogu
ohu	f	ohu
oia	f	oia
oin	f	oin
ojb	f	ojb
ojc	f	ojc
ojg	f	ojg
ojp	f	ojp
ojs	f	ojs
ojv	f	ojv
ojw	f	ojw
oka	f	oka
okb	f	okb
okd	f	okd
oke	f	oke
okg	f	okg
okh	f	okh
oki	f	oki
okj	f	okj
okk	f	okk
okl	f	okl
okm	t	okm
okn	f	okn
oko	f	oko
okr	f	okr
oks	f	oks
oku	f	oku
okv	f	okv
okx	f	okx
old	f	old
ole	f	ole
olm	f	olm
olo	f	olo
olr	f	olr
olt	t	olt
olu	f	olu
oma	f	oma
omb	f	omb
omc	f	omc
omg	f	omg
omi	f	omi
omk	f	omk
oml	f	oml
omn	f	omn
omo	f	omo
omp	f	omp
omr	f	omr
omt	f	omt
omu	f	omu
omw	f	omw
omx	f	omx
ona	f	ona
onb	f	onb
one	f	one
ong	f	ong
oni	f	oni
onj	f	onj
onk	f	onk
onn	f	onn
ono	f	ono
onp	f	onp
onr	f	onr
ons	f	ons
ont	f	ont
onu	f	onu
onw	f	onw
onx	f	onx
ood	f	ood
oog	f	oog
oon	f	oon
oor	f	oor
oos	f	oos
opa	f	opa
opk	f	opk
opm	f	opm
opo	f	opo
opt	f	opt
opy	f	opy
ora	f	ora
ore	f	ore
org	f	org
orh	f	orh
oro	f	oro
orr	f	orr
ort	f	ort
oru	f	oru
orv	t	orv
orw	f	orw
orx	f	orx
orz	f	orz
osa	f	osa
osc	f	osc
osi	f	osi
osn	f	osn
oso	f	oso
osp	f	osp
ost	f	ost
osu	f	osu
osx	t	osx
ota	f	ota
otd	f	otd
ote	f	ote
oti	f	oti
otk	f	otk
otl	f	otl
otm	f	otm
otn	f	otn
otq	f	otq
otr	f	otr
ots	f	ots
ott	f	ott
otu	f	otu
otw	f	otw
otx	f	otx
oty	f	oty
otz	f	otz
oub	f	oub
oue	f	oue
oui	f	oui
oum	f	oum
ovd	f	ovd
owi	f	owi
owl	f	owl
oyb	f	oyb
oyd	f	oyd
oym	f	oym
oyy	f	oyy
ozm	f	ozm
pab	f	pab
pac	f	pac
pad	f	pad
pae	f	pae
paf	f	paf
pag	f	pag
pah	f	pah
pai	f	pai
pak	f	pak
pal	f	pal
pam	f	pam
pao	f	pao
pap	f	pap
paq	f	paq
par	f	par
pas	f	pas
pat	f	pat
pau	f	pau
pav	f	pav
paw	f	paw
pax	f	pax
pay	f	pay
paz	f	paz
pbb	f	pbb
pbc	f	pbc
pbe	f	pbe
pbf	f	pbf
pbg	f	pbg
pbh	f	pbh
pbi	f	pbi
pbl	f	pbl
pbm	f	pbm
pbn	f	pbn
pbo	f	pbo
pbp	f	pbp
pbr	f	pbr
pbs	f	pbs
pbv	f	pbv
pby	f	pby
pca	f	pca
pcb	f	pcb
pcc	f	pcc
pcd	f	pcd
pce	f	pce
pcf	f	pcf
pcg	f	pcg
pch	f	pch
pci	f	pci
pcj	f	pcj
pck	f	pck
pcl	f	pcl
pcm	f	pcm
pcn	f	pcn
pcp	f	pcp
pcw	f	pcw
pda	f	pda
pdc	f	pdc
pdi	f	pdi
pdn	f	pdn
pdo	f	pdo
pdt	f	pdt
pdu	f	pdu
pea	f	pea
peb	f	peb
ped	f	ped
pee	f	pee
pef	f	pef
peg	f	peg
peh	f	peh
pei	f	pei
pej	f	pej
pek	f	pek
pel	f	pel
pem	f	pem
peo	f	peo
pep	f	pep
peq	f	peq
pev	f	pev
pex	f	pex
pey	f	pey
pez	f	pez
pfa	f	pfa
pfe	f	pfe
pga	f	pga
pgd	f	pgd
pgg	f	pgg
pgi	f	pgi
pgk	f	pgk
pgl	f	pgl
pgn	f	pgn
pgs	f	pgs
pgu	f	pgu
pgz	f	pgz
pha	f	pha
phd	f	phd
phg	f	phg
phh	f	phh
phk	t	phk
phl	f	phl
phm	f	phm
phn	f	phn
pho	f	pho
phq	f	phq
phr	f	phr
pht	f	pht
phu	f	phu
phv	f	phv
phw	f	phw
pia	f	pia
pib	f	pib
pic	f	pic
pid	f	pid
pie	f	pie
pif	f	pif
pig	f	pig
pih	f	pih
pii	f	pii
pij	f	pij
pil	f	pil
pim	f	pim
pin	f	pin
pio	f	pio
pip	f	pip
pir	f	pir
pis	f	pis
pit	f	pit
piu	f	piu
piv	f	piv
piw	f	piw
pix	f	pix
piy	f	piy
piz	f	piz
pjt	f	pjt
pka	f	pka
pkb	f	pkb
pkc	f	pkc
pkg	f	pkg
pkh	f	pkh
pkn	f	pkn
pko	f	pko
pkp	f	pkp
pkr	f	pkr
pks	f	pks
pkt	f	pkt
pku	f	pku
pla	f	pla
plb	f	plb
plc	f	plc
ple	f	ple
plg	f	plg
plh	f	plh
plj	f	plj
plk	f	plk
pll	f	pll
pln	f	pln
plo	f	plo
plq	f	plq
plr	f	plr
pls	f	pls
plu	f	plu
plv	f	plv
plw	f	plw
ply	f	ply
plz	f	plz
pma	f	pma
pmb	f	pmb
pmd	f	pmd
pme	f	pme
pmf	f	pmf
pmh	f	pmh
pmi	f	pmi
pmj	f	pmj
pmk	f	pmk
pml	f	pml
pmm	f	pmm
pmn	f	pmn
pmo	f	pmo
pmq	f	pmq
pmr	f	pmr
pms	f	pms
pmt	f	pmt
pmu	f	pmu
pmw	f	pmw
pmx	f	pmx
pmy	f	pmy
pmz	f	pmz
pna	f	pna
pnb	f	pnb
pnc	f	pnc
pnd	f	pnd
pne	f	pne
png	f	png
pnh	f	pnh
pni	f	pni
pnj	f	pnj
pnk	f	pnk
pnl	f	pnl
pnm	f	pnm
pnn	f	pnn
pno	f	pno
pnp	f	pnp
pnq	f	pnq
pnr	f	pnr
pns	f	pns
pnt	f	pnt
pnu	f	pnu
pnv	f	pnv
pnw	f	pnw
pnx	f	pnx
pny	f	pny
pnz	f	pnz
poc	f	poc
poe	f	poe
pof	f	pof
pog	f	pog
poh	f	poh
poi	f	poi
pok	f	pok
pom	f	pom
pon	f	pon
poo	f	poo
pop	f	pop
poq	f	poq
pos	f	pos
pot	f	pot
pov	f	pov
pow	f	pow
pox	f	pox
poy	f	poy
ppa	f	ppa
ppe	f	ppe
ppi	f	ppi
ppk	f	ppk
ppl	t	ppl
ppm	f	ppm
ppn	f	ppn
ppo	f	ppo
ppq	f	ppq
pps	f	pps
ppt	f	ppt
ppu	f	ppu
pqa	f	pqa
pqm	f	pqm
prc	f	prc
pre	f	pre
prf	f	prf
prg	f	prg
prh	f	prh
pri	f	pri
prk	f	prk
prl	f	prl
prm	f	prm
prn	f	prn
pro	f	pro
prq	f	prq
prr	f	prr
prt	f	prt
pru	f	pru
prw	f	prw
prx	f	prx
prz	f	prz
psa	f	psa
psc	f	psc
psd	f	psd
pse	f	pse
psg	f	psg
psh	f	psh
psi	f	psi
psl	f	psl
psm	f	psm
psn	f	psn
pso	f	pso
psp	f	psp
psq	f	psq
psr	f	psr
pss	f	pss
psu	f	pra
psw	f	psw
psy	f	psy
pta	f	pta
pth	f	pth
pti	f	pti
ptn	f	ptn
pto	f	pto
ptp	f	ptp
ptq	f	ptq
ptr	f	ptr
ptt	f	ptt
ptu	f	ptu
ptv	f	ptv
ptw	f	ptw
pty	f	pty
pua	f	pua
pub	f	pub
puc	f	puc
pud	f	pud
pue	f	pue
puf	f	puf
pug	f	pug
pui	f	pui
puj	f	puj
pum	f	pum
puo	f	puo
pup	f	pup
puq	f	puq
pur	f	pur
put	f	put
puu	f	puu
puw	f	puw
pux	f	pux
puy	f	puy
pwa	f	pwa
pwb	f	pwb
pwg	f	pwg
pwi	f	pwi
pwm	f	pwm
pwn	f	pwn
pwo	f	pwo
pwr	f	pwr
pww	f	pww
pxm	f	pxm
pye	f	pye
pym	f	pym
pyn	f	pyn
pys	f	pys
pyu	f	pyu
pyx	f	pyx
pyy	f	pyy
pzn	f	pzn
qua	f	qua
quc	f	quc
qui	f	qui
qum	f	qum
qun	f	qun
quq	f	quq
quv	f	quv
qvy	f	qvy
qwc	f	qwc
qwm	f	qwm
qwt	f	qwt
qxs	f	qxs
qya	f	qya
qyp	f	qyp
raa	f	raa
rab	f	rab
rac	f	rac
rad	f	rad
raf	f	raf
rag	f	rag
rah	f	rah
rai	f	rai
raj	f	raj
rak	f	rak
ral	f	ral
ram	f	ram
ran	f	ran
rao	f	rao
rap	f	rap
raq	f	raq
rar	f	rar
ras	f	ras
rat	f	rat
rau	f	rau
rav	f	rav
raw	f	raw
rax	f	rax
ray	f	ray
raz	f	raz
rbb	f	rbb
rbk	f	rbk
rbl	f	rbl
rcf	f	rcf
rdb	f	rdb
rea	f	rea
reb	f	reb
ree	f	ree
reg	f	reg
rei	f	rei
rej	f	rej
rel	f	rel
rem	f	rem
ren	f	ren
rer	f	rer
res	f	res
ret	f	ret
rey	f	rey
rga	f	rga
rge	f	rge
rgk	f	rgk
rgn	f	rgn
rgr	f	rgr
rgs	f	rgs
rgu	f	rgu
rhg	f	rhg
rhp	f	rhp
ria	f	ria
rif	f	rif
ril	f	ril
rim	f	rim
rin	f	rin
rir	f	rir
rit	f	rit
riu	f	riu
rjg	f	rjg
rji	f	rji
rjs	f	rjs
rka	f	rka
rkb	f	rkb
rkh	f	rkh
rki	f	rki
rkm	f	rkm
rkt	f	rkt
rkw	f	rkw
rma	f	rma
rmb	f	rmb
rmc	f	rmc
rmd	f	rmd
rme	f	rme
rmf	f	rmf
rmg	f	rmg
rmh	f	rmh
rmi	f	rmi
rmk	f	rmk
rml	f	rml
rmm	f	rmm
rmn	f	rmn
rmo	f	rmo
rmp	f	rmp
rmq	f	rmq
rms	f	rms
rmt	f	rmt
rmu	f	rmu
rmv	f	rmv
rmw	f	rmw
rmx	f	rmx
rmy	f	rmy
rmz	f	rmz
rnd	f	rnd
rng	f	rng
rnl	f	rnl
rnn	f	rnn
rnp	f	rnp
rnw	f	rnw
rob	f	rob
roc	f	roc
rod	f	rod
roe	f	roe
rof	f	rof
rog	f	rog
rol	f	rol
rom	f	rom
roo	f	roo
rop	f	rop
ror	f	ror
rou	f	rou
row	f	row
rpn	f	rpn
rpt	f	rpt
rri	f	rri
rro	f	rro
rrt	f	rrt
rsb	f	rsb
rsl	f	rsl
rsm	f	rsm
rtc	f	rtc
rth	f	rth
rtm	f	rtm
rtw	f	rtw
rub	f	rub
ruc	f	ruc
rue	t	rue
ruf	f	ruf
rug	f	rug
ruh	f	ruh
rui	f	rui
ruk	f	ruk
ruo	f	ruo
rup	f	rup
ruq	f	ruq
rut	f	rut
ruu	f	ruu
ruy	f	ruy
ruz	f	ruz
rwa	f	rwa
rwk	f	rwk
rwm	f	rwm
rwo	f	rwo
rxd	f	rxd
rxw	f	rxw
ryn	f	ryn
rys	f	rys
ryu	f	ryu
rzh	f	rzh
saa	f	saa
sab	f	sab
sac	f	sac
sad	f	sad
sae	f	sae
saf	f	saf
sah	f	sah
saj	f	saj
sak	f	sak
sam	t	sam
sao	f	sao
saq	f	saq
sar	f	sar
sas	f	sas
sat	f	sat
sau	f	sau
sav	f	sav
saw	f	saw
sax	f	sax
say	f	say
saz	f	saz
sba	f	sba
sbb	f	sbb
sbc	f	sbc
sbd	f	sbd
sbe	f	sbe
sbf	f	sbf
sbg	f	sbg
sbh	f	sbh
sbi	f	sbi
sbj	f	sbj
sbk	f	sbk
sbl	f	sbl
sbm	f	sbm
sbn	f	sbn
sbo	f	sbo
sbp	f	sbp
sbq	f	sbq
sbr	f	sbr
sbs	f	sbs
sbt	f	sbt
sbu	f	sbu
sbv	f	sbv
sbw	f	sbw
sbx	f	sbx
sby	f	sby
sbz	f	sbz
scb	f	scb
sce	f	sce
scf	f	scf
scg	f	scg
sch	f	sch
sci	f	sci
sck	f	sck
scl	f	scl
scn	f	scn
sco	f	sco
scp	f	scp
scq	f	scq
scs	f	scs
scu	f	scu
scv	f	scv
scw	f	scw
scx	f	scx
sda	f	sda
sdb	f	sdb
sdc	f	sdc
sde	f	sde
sdf	f	sdf
sdg	f	sdg
sdh	t	sdh
sdj	f	sdj
sdk	f	sdk
sdl	f	sdl
sdm	f	sdm
sdn	f	sdn
sdo	f	sdo
sdp	f	sdp
sdr	f	sdr
sds	f	sds
sdu	f	sdu
sdx	f	sdx
sea	f	sea
sec	f	sec
sed	f	sed
see	f	see
sef	f	sef
seg	f	seg
seh	f	seh
sei	f	sei
sej	f	sej
sek	f	sek
sel	f	sel
sen	f	sen
seo	f	seo
sep	f	sep
seq	f	seq
ser	f	ser
ses	f	ses
set	f	set
seu	f	seu
sev	f	sev
sew	f	sew
sey	f	sey
sez	f	sez
sfb	f	sfb
sfm	f	sfm
sfs	f	sfs
sfw	f	sfw
sga	t	sga
sgb	f	sgb
sgc	f	sgc
sgd	f	sgd
sge	f	sge
sgg	f	sgg
sgh	f	sgh
sgi	f	sgi
sgk	f	sgk
sgm	f	sgm
sgp	f	sgp
sgr	f	sgr
sgs	f	sgs
sgt	f	sgt
sgu	f	sgu
sgw	f	sgw
sgx	f	sgx
sgy	f	sgy
sgz	f	sgz
sha	f	sha
shb	f	shb
shc	f	shc
shd	f	shd
she	f	she
shg	f	shg
shh	f	shh
shi	f	shi
shj	f	shj
shk	f	shk
shl	f	shl
shm	f	shm
shn	f	shn
sho	f	sho
shp	f	shp
shq	f	shq
shr	f	shr
shs	f	shs
sht	f	sht
shu	t	shu
shv	f	shv
shw	f	shw
shx	f	shx
shy	f	shy
shz	f	shz
sia	f	sia
sib	f	sib
sid	f	sid
sie	f	sie
sif	f	sif
sig	f	sig
sih	f	sih
sii	f	sii
sij	f	sij
sik	f	sik
sil	f	sil
sim	f	sim
sip	f	sip
siq	f	siq
sir	f	sir
sis	f	sis
siu	f	siu
siv	f	siv
siw	f	siw
six	f	six
siy	f	siy
siz	f	siz
sja	f	sja
sjb	f	sjb
sjd	f	sjd
sje	t	sje
sjg	f	sjg
sjk	f	sjk
sjl	f	sjl
sjm	f	sjm
sjn	f	sjn
sjo	f	sjo
sjp	f	sjp
sjr	f	sjr
sjs	f	sjs
sjt	f	sjt
sju	t	sju
sjw	f	sjw
ska	f	ska
skb	f	skb
skc	f	skc
skd	f	skd
ske	f	ske
skf	f	skf
skh	f	skh
ski	f	ski
skj	f	skj
skk	f	skk
skm	f	skm
skn	f	skn
sko	f	sko
skp	f	skp
skq	f	skq
skr	t	skr
sks	f	sks
skt	f	skt
sku	f	sku
skv	f	skv
skw	f	skw
skx	f	skx
sky	f	sky
skz	f	skz
slc	f	slc
sld	f	sld
sle	f	sle
slf	f	slf
slg	f	slg
slh	f	slh
slj	f	slj
sll	f	sll
slm	f	slm
sln	f	sln
slp	f	slp
slq	f	slq
slr	f	slr
sls	f	sls
slt	f	slt
slu	f	slu
slw	f	slw
slx	f	slx
sly	f	sly
slz	f	slz
sma	f	sma
smb	f	smb
smc	f	smc
smd	f	smd
smf	f	smf
smg	f	smg
smh	f	smh
smj	t	smj
smk	f	smk
sml	f	sml
smm	f	smm
smn	t	smn
smp	t	smp
smq	f	smq
smr	f	smr
sms	t	sms
smt	f	smt
smu	f	smu
smv	f	smv
smw	f	smw
smx	f	smx
smy	f	smy
smz	f	smz
snb	f	snb
snc	f	snc
sne	f	sne
snf	f	snf
sng	f	sng
sni	f	sni
snj	f	snj
snk	f	snk
snl	f	snl
snm	f	snm
snn	f	snn
sno	f	sno
snp	f	snp
snq	f	snq
snr	f	snr
sns	f	sns
snu	f	snu
snv	f	snv
snw	f	snw
snx	f	snx
sny	f	sny
snz	f	snz
soa	f	soa
sob	f	sob
soc	f	soc
sod	f	sod
soe	f	soe
sog	f	sog
soh	f	soh
soi	f	soi
sok	f	sok
sol	f	sol
soo	f	soo
sop	f	sop
soq	f	soq
sor	f	sor
sos	f	sos
sou	f	sou
sov	f	sov
sow	f	sow
sox	f	sox
soy	f	soy
soz	f	soz
spb	f	spb
spc	f	spc
spd	f	spd
spe	f	spe
spg	f	spg
spi	f	spi
spk	f	spk
spl	f	spl
spm	f	spm
spn	f	spn
spo	f	spo
spp	f	spp
spr	f	spr
sps	f	sps
spt	f	spt
spu	f	spu
spv	f	spv
spx	f	spx
spy	f	spy
sqa	f	sqa
sqh	f	sqh
sqk	f	sqk
sqm	f	sqm
sqn	f	sqn
sqo	f	sqo
sqq	f	sqq
sqr	f	sqr
sqs	f	sqs
sqt	f	sqt
squ	f	squ
sra	f	sra
srb	f	srb
sre	f	sre
srf	f	srf
srg	f	srg
srh	f	srh
sri	f	sri
srk	f	srk
srl	f	srl
srm	f	srm
srn	f	srn
srq	f	srq
srr	f	srr
srs	f	srs
srt	f	srt
sru	f	sru
srv	f	srv
srw	f	srw
srx	f	srx
sry	f	sry
srz	f	srz
ssb	f	ssb
ssc	f	ssc
ssd	f	ssd
sse	f	sse
ssf	f	ssf
ssg	f	ssg
ssh	t	ssh
ssi	f	ssi
ssj	f	ssj
ssk	f	ssk
ssl	f	ssl
ssm	f	ssm
sso	f	sso
ssp	f	ssp
ssq	f	ssq
ssr	f	ssr
sss	f	sss
sst	f	sst
ssu	f	ssu
ssv	f	ssv
ssx	f	ssx
ssy	t	ssy
ssz	f	ssz
stb	f	stb
std	f	std
ste	f	ste
stf	f	stf
stg	f	stg
sth	f	sth
sti	f	sti
stj	f	stj
stk	f	stk
stm	f	stm
stn	f	stn
sto	f	sto
stp	f	stp
stq	f	stq
str	f	str
sts	f	sts
stt	f	stt
stu	f	stu
stv	f	stv
stw	f	stw
sty	f	sty
sua	f	sua
sub	f	sub
suc	f	suc
sue	f	sue
sug	f	sug
sui	f	sui
suk	f	suk
suq	f	suq
sur	f	sur
sus	f	sus
sut	f	sut
suv	f	suv
suw	f	suw
sux	f	sux
suy	f	suy
suz	f	suz
sva	f	sva
svb	f	svb
svc	f	svc
sve	f	sve
svk	f	svk
svm	f	svm
svs	f	svs
svx	f	svx
swb	f	swb
swf	f	swf
swg	f	swg
swi	f	swi
swj	f	swj
swl	f	swl
swm	f	swm
swn	f	swn
swo	f	swo
swp	f	swp
swq	f	swq
swr	f	swr
sws	f	sws
swt	f	swt
swu	f	swu
sww	f	sww
swx	f	swx
swy	f	swy
sxb	f	sxb
sxc	f	sxc
sxe	f	sxe
sxg	f	sxg
sxk	f	sxk
sxl	f	sxl
sxm	f	sxm
sxn	f	sxn
sxo	f	sxo
sxr	f	sxr
sxs	f	sxs
sxw	f	sxw
sya	f	sya
syb	f	syb
syc	t	syc
syi	f	syi
syk	f	syk
syl	f	syl
sym	f	sym
syn	f	syn
syo	f	syo
sys	f	sys
syw	f	syw
syx	f	syx
syy	f	syy
sza	f	sza
szb	f	szb
szc	f	szc
szd	f	szd
sze	f	sze
szg	f	szg
szl	f	szl
szn	f	szn
szp	f	szp
szv	f	szv
szw	f	szw
szy	f	szy
taa	f	taa
tab	t	tab
tac	f	tac
tad	f	tad
tae	f	tae
taf	f	taf
tag	f	tag
taj	f	taj
tak	f	tak
tal	f	tal
tan	f	tan
tao	f	tao
tap	f	tap
tar	f	tar
tas	f	tas
tau	f	tau
tav	f	tav
taw	f	tai
tax	f	tax
tay	f	tay
taz	f	taz
tba	f	tba
tbb	f	tbb
tbc	f	tbc
tbd	f	tbd
tbe	f	tbe
tbf	f	tbf
tbg	f	tbg
tbh	f	tbh
tbi	f	tbi
tbj	f	tbj
tbk	f	tbk
tbl	f	tbl
tbm	f	tbm
tbn	f	tbn
tbo	f	tbo
tbp	f	tbp
tbr	f	tbr
tbs	f	tbs
tbt	f	tbt
tbu	f	tbu
tbv	f	tbv
tbw	f	tbw
tbx	f	tbx
tby	f	tby
tbz	f	tbz
tca	f	tca
tcb	f	tcb
tcc	f	tcc
tcd	f	tcd
tce	f	tce
tcf	f	tcf
tcg	f	tcg
tch	f	tch
tci	f	tci
tck	f	tck
tcl	f	tcl
tcm	f	tcm
tco	f	tco
tcp	f	tcp
tcq	f	tcq
tcs	f	tcs
tct	f	tct
tcu	f	tcu
tcw	f	tcw
tcx	f	tcx
tcy	f	tcy
tcz	f	tcz
tda	f	tda
tdb	f	tdb
tdc	f	tdc
tdd	t	tdd
tde	f	tde
tdf	f	tdf
tdg	f	tdg
tdh	f	tdh
tdi	f	tdi
tdj	f	tdj
tdk	f	tdk
tdl	f	tdl
tdm	f	tdm
tdn	f	tdn
tdo	f	tdo
tdq	f	tdq
tdr	f	tdr
tds	f	tds
tdt	f	tdt
tdu	f	tdu
tdv	f	tdv
tdy	f	tdy
tea	f	tea
teb	f	teb
tec	f	tec
ted	f	ted
tee	f	tee
tef	f	tef
teg	f	teg
teh	f	teh
tei	f	tei
tek	f	tek
tem	f	tem
ten	f	ten
teo	f	teo
tep	f	tep
teq	f	teq
ter	f	ter
tes	f	tes
tet	f	tet
teu	f	teu
tev	f	tev
tew	f	tew
tex	f	tex
tey	f	tey
tez	f	tez
tfi	f	tfi
tfn	f	tfn
tfo	f	tfo
tfr	f	tfr
tft	f	tft
tga	f	tga
tgb	f	tgb
tgc	f	tgc
tgd	f	tgd
tge	f	tge
tgf	f	tgf
tgh	f	tgh
tgi	f	tgi
tgn	f	tgn
tgo	f	tgo
tgp	f	tgp
tgq	f	tgq
tgr	f	tgr
tgs	f	tgs
tgt	f	tgt
tgu	f	tgu
tgv	f	tgv
tgw	f	tgw
tgx	f	tgx
tgy	f	tgy
thc	f	thc
thd	f	thd
the	f	the
thf	f	thf
thh	f	thh
thi	f	thi
thk	f	thk
thl	f	thl
thm	f	thm
thn	f	thn
thp	f	thp
thq	f	thq
thr	f	thr
ths	f	ths
tht	f	tht
thu	f	thu
thy	f	thy
tic	f	tic
tif	f	tif
tig	f	tig
tih	f	tih
tii	f	tii
tij	f	tij
tik	f	tik
til	f	til
tim	f	tim
tin	f	tin
tio	f	tio
tip	f	tip
tiq	f	tiq
tis	f	tis
tit	f	tit
tiu	f	tiu
tiv	f	tiv
tiw	f	tiw
tix	f	tix
tiy	f	tiy
tiz	f	tiz
tja	f	tja
tjg	f	tjg
tji	f	tji
tjl	f	tjl
tjm	f	tjm
tjn	f	tjn
tjs	f	tjs
tju	f	tju
tjw	f	tjw
tka	f	tka
tkb	f	tkb
tkd	f	tkd
tke	f	tke
tkf	f	tkf
tkl	f	tkl
tkm	f	tkm
tkn	f	tkn
tkp	f	tkp
tkq	f	tkq
tkr	f	tkr
tks	f	tks
tkt	f	tkt
tku	f	tku
tkv	f	tkv
tkw	f	tkw
tkx	f	tkx
tkz	f	tkz
tla	f	tla
tlb	f	tlb
tlc	f	tlc
tld	f	tld
tlf	f	tlf
tlg	f	tlg
tlh	f	tlh
tli	f	tli
tlj	f	tlj
tlk	f	tlk
tll	f	tll
tlm	f	tlm
tln	f	tln
tlo	f	tlo
tlp	f	tlp
tlq	f	tlq
tlr	f	tlr
tls	f	tls
tlt	f	tlt
tlu	f	tlu
tlv	f	tlv
tlx	f	tlx
tly	f	tly
tma	f	tma
tmb	f	tmb
tmc	f	tmc
tmd	f	tmd
tme	f	tme
tmf	f	tmf
tmg	f	tmg
tmh	t	tmh
tmi	f	tmi
tmj	f	tmj
tmk	f	tmk
tml	f	tml
tmm	f	tmm
tmn	f	tmn
tmo	f	tmo
tmp	f	tmp
tmq	f	tmq
tms	f	tms
tmt	f	tmt
tmu	f	tmu
tmv	f	tmv
tmy	f	tmy
tmz	f	tmz
tna	f	tna
tnb	f	tnb
tnc	f	tnc
tnd	f	tnd
tne	f	tne
tng	f	tng
tnh	f	tnh
tni	f	tni
tnk	f	tnk
tnl	f	tnl
tnm	f	tnm
tnn	f	tnn
tno	f	tno
tnp	f	tnp
tnq	f	tnq
tnr	f	tnr
tns	f	tns
tnt	f	tnt
tnu	f	tnu
tnv	f	tnv
tnw	f	tnw
tnx	f	tnx
tny	f	tny
tnz	f	tnz
tob	f	tob
toc	f	toc
tod	f	tod
tof	f	tof
tog	f	tog
toh	f	toh
toi	f	toi
toj	f	toj
tok	f	tok
tol	f	tol
tom	f	tom
too	f	too
top	f	top
toq	f	toq
tor	f	tor
tos	f	tos
tou	f	tou
tov	f	tov
tow	f	tow
tox	f	tox
toy	f	toy
toz	f	toz
tpa	f	tpa
tpc	f	tpc
tpe	f	tpe
tpf	f	tpf
tpg	f	tpg
tpi	f	tpi
tpj	f	tpj
tpk	f	tpk
tpl	f	tpl
tpm	f	tpm
tpn	f	tpn
tpo	f	tpo
tpp	f	tpp
tpq	f	tpq
tpr	f	tpr
tpt	f	tpt
tpu	f	tpu
tpv	f	tpv
tpw	f	tpw
tpx	f	tpx
tpy	f	tpy
tpz	f	tpz
tqb	f	tqb
tql	f	tql
tqm	f	tqm
tqn	f	tqn
tqo	f	tqo
tqp	f	tqp
tqq	f	tqq
tqr	f	tqr
tqt	f	tqt
tqu	f	tqu
tqw	f	tqw
tra	f	tra
trb	f	trb
trc	f	trc
trd	f	trd
tre	f	tre
trf	f	trf
trg	f	trg
trh	f	trh
tri	f	tri
trj	f	trj
trl	f	trl
trm	f	trm
trn	f	trn
tro	f	tro
trp	f	trp
trq	f	trq
trr	f	trr
trs	f	trs
trt	f	trt
tru	t	tru
trv	f	trv
trw	f	trw
trx	f	trx
try	f	try
trz	f	trz
tsa	f	tsa
tsb	f	tsb
tsc	f	tsc
tsd	f	tsd
tse	f	tse
tsf	f	tsf
tsg	f	tsg
tsh	f	tsh
tsi	f	tsi
tsj	f	tsj
tsl	f	tsl
tsm	f	tsm
tsp	f	tsp
tsq	f	tsq
tsr	f	tsr
tss	f	tss
tsu	f	tsu
tsv	f	tsv
tsw	f	tsw
tsx	f	tsx
tsy	f	tsy
tta	f	tta
ttb	f	ttb
ttc	f	ttc
ttd	f	ttd
tte	f	tte
ttf	f	ttf
ttg	f	ttg
tth	f	tth
tti	f	tti
ttj	f	ttj
ttk	f	ttk
ttl	f	ttl
ttm	f	ttm
ttn	f	ttn
tto	f	tto
ttp	f	ttp
ttr	f	ttr
tts	f	tts
ttt	f	ttt
ttu	f	ttu
ttv	f	ttv
ttw	f	ttw
tty	f	tty
ttz	f	ttz
tua	f	tua
tub	f	tub
tuc	f	tuc
tud	f	tud
tue	f	tue
tuf	f	tuf
tug	f	tug
tuh	f	tuh
tui	f	tui
tuj	f	tuj
tul	f	tul
tum	f	tum
tun	f	tun
tuo	f	tuo
tuq	f	tuq
tus	f	tus
tuu	f	tuu
tuv	f	tuv
tux	f	tux
tuy	f	tuy
tuz	f	tuz
tva	f	tva
tvd	f	tvd
tve	f	tve
tvk	f	tvk
tvl	f	tvl
tvm	f	tvm
tvn	f	tvn
tvo	f	tvo
tvs	f	tvs
tvt	f	tvt
tvu	f	tvu
tvw	f	tvw
tvx	f	tvx
tvy	f	tvy
twa	f	twa
twb	f	twb
twc	f	twc
twe	f	twe
twf	f	twf
twg	f	twg
twh	f	twh
twm	f	twm
twn	f	twn
two	f	two
twp	f	twp
twq	f	twq
twr	f	twr
twt	f	twt
twu	f	twu
tww	f	tww
twy	f	twy
txa	f	txa
txb	f	txb
txc	f	txc
txe	f	txe
txg	f	txg
txh	f	txh
txi	f	txi
txj	f	txj
txm	f	txm
txn	f	txn
txo	f	txo
txq	f	txq
txr	f	txr
txs	f	txs
txt	f	txt
txu	f	txu
txx	f	txx
tya	f	tya
tye	f	tye
tyh	f	tyh
tyi	f	tyi
tyj	f	tyj
tyl	f	tyl
tyn	f	tyn
typ	f	typ
tyr	f	tyr
tys	f	tys
tyt	f	tyt
tyu	f	tyu
tyv	f	tyv
tyx	f	tyx
tyz	f	tyz
tza	f	tza
tzh	f	tzh
tzj	f	tzj
tzl	f	tzl
tzm	f	tzm
tzn	f	tzn
tzo	f	tzo
tzx	f	tzx
uam	f	uam
uan	f	uan
uar	f	uar
uba	f	uba
ubi	f	ubi
ubl	f	ubl
ubr	f	ubr
ubu	f	ubu
uby	f	uby
uda	f	uda
ude	f	ude
udg	f	udg
udi	f	udi
udj	f	udj
udl	f	udl
udm	f	udm
udu	f	udu
ues	f	ues
ufi	f	ufi
uga	f	uga
ugb	f	ugb
uge	f	uge
ugn	f	ugn
ugo	f	ugo
ugy	f	ugy
uha	f	uha
uhn	f	uhn
uis	f	uis
uiv	f	uiv
uji	f	uji
uka	f	uka
ukg	f	ukg
ukh	f	ukh
ukk	f	ukk
ukl	f	ukl
ukp	f	ukp
ukq	f	ukq
uks	f	uks
uku	f	uku
ukw	f	ukw
uky	f	uky
ula	f	ula
ulb	f	ulb
ulc	f	ulc
ule	f	ule
ulf	f	ulf
uli	f	uli
ulk	f	ulk
ull	f	ull
ulm	f	ulm
uln	f	uln
ulu	f	ulu
ulw	f	ulw
uma	f	uma
umb	f	umb
umc	f	umc
umd	f	umd
umg	f	umg
umi	f	umi
umm	f	umm
umn	f	umn
umo	f	umo
ump	f	ump
umr	f	umr
ums	f	ums
umu	t	umu
una	f	una
und	f	und
une	f	une
ung	f	ung
unk	f	unk
unm	f	unm
unn	f	unn
unr	f	unr
unu	f	unu
unx	f	mun
unz	f	unz
uok	f	uok
upi	f	upi
upv	f	upv
ura	f	ura
urb	f	urb
urc	f	urc
ure	f	ure
urf	f	urf
urg	f	urg
urh	f	urh
uri	f	uri
urk	f	urk
url	f	url
urm	f	urm
urn	f	urn
uro	f	uro
urp	f	urp
urr	f	urr
urt	f	urt
uru	f	uru
urv	f	urv
urw	f	urw
urx	f	urx
ury	f	ury
urz	f	urz
usa	f	usa
ush	f	ush
usi	f	usi
usk	f	usk
usp	f	usp
uss	f	uss
usu	f	usu
uta	f	uta
ute	f	ute
uth	f	uth
utp	f	utp
utr	f	utr
utu	f	utu
uum	f	uum
uun	f	uun
uur	f	uur
uuu	f	uuu
uve	f	uve
uvh	f	uvh
uvl	f	uvl
uwa	f	uwa
uya	f	uya
vaa	f	vaa
vae	f	vae
vag	f	vag
vah	f	vah
vai	f	vai
vaj	f	vaj
val	f	val
vam	f	vam
van	f	van
vao	f	vao
vap	f	vap
var	f	var
vas	f	vas
vau	f	vau
vav	f	vav
vay	f	vay
vbb	f	vbb
vbk	f	vbk
vec	f	vec
ved	f	ved
vem	f	vem
veo	f	veo
vep	f	vep
ver	f	ver
vgr	f	vgr
vgt	f	vgt
vic	f	vic
vid	f	vid
vif	f	vif
vig	f	vig
vil	f	vil
vis	f	vis
vit	f	vit
viv	f	viv
vka	f	vka
vki	f	vki
vkj	f	vkj
vkk	f	vkk
vkl	f	vkl
vkm	f	vkm
vko	f	vko
vkp	f	vkp
vkt	f	vkt
vku	f	vku
vlp	f	vlp
vls	f	vls
vma	f	vma
vmb	f	vmb
vmc	f	vmc
vmd	f	vmd
vme	f	vme
vmf	f	vmf
vmg	f	vmg
vmh	f	vmh
vmi	f	vmi
vmj	f	vmj
vmk	f	vmk
vml	f	vml
vmm	f	vmm
vmp	f	vmp
vmq	f	vmq
vmr	f	vmr
vmu	f	vmu
vmv	f	vmv
vmw	f	vmw
vmx	f	vmx
vmy	f	vmy
vmz	f	vmz
vnk	f	vnk
vnm	f	vnm
vnp	f	vnp
vor	f	vor
vot	f	vot
vra	f	vra
vro	f	vro
vrs	f	vrs
vrt	f	vrt
vsi	f	vsi
vsl	f	vsl
vsv	f	vsv
vto	f	vto
vum	f	vum
vun	f	vun
vut	f	vut
vwa	f	vwa
waa	f	waa
wab	f	wab
wac	f	wac
wad	f	wad
waf	f	waf
wag	f	wag
wah	f	wah
waj	f	waj
wal	f	wal
wam	f	wam
wan	f	wan
wao	f	wao
wap	f	wap
waq	f	waq
war	f	war
was	f	was
wat	f	wat
wau	f	wau
wav	f	wav
waw	f	waw
wax	f	wax
way	f	way
waz	f	waz
wba	f	wba
wbb	f	wbb
wbe	f	wbe
wbf	f	wbf
wbh	f	wbh
wbi	f	wbi
wbj	f	wbj
wbk	f	wbk
wbl	f	wbl
wbm	f	wbm
wbp	f	wbp
wbq	f	wbq
wbr	f	wbr
wbt	f	wbt
wbv	f	wbv
wbw	f	wbw
wca	f	wca
wci	f	wci
wdd	f	wdd
wdg	f	wdg
wdj	f	wdj
wdu	f	wdu
wdy	f	wdy
wea	f	wea
wec	f	wec
wed	f	wed
weh	f	weh
wei	f	wei
wem	f	wem
weo	f	weo
wer	f	wer
wes	f	wes
wet	f	wet
weu	f	weu
wew	f	wew
wfg	f	wfg
wga	f	wga
wgb	f	wgb
wgg	f	wgg
wgi	f	wgi
wgo	f	wgo
wgu	f	wgu
wgy	f	wgy
wha	f	wha
whg	f	whg
whk	f	whk
whu	f	whu
wib	f	wib
wic	f	wic
wie	f	wie
wif	f	wif
wig	f	wig
wih	f	wih
wii	f	wii
wij	f	wij
wik	f	wik
wil	f	wil
wim	f	wim
win	f	win
wir	f	wir
wiu	f	wiu
wiv	f	wiv
wiy	f	wiy
wja	f	wja
wji	f	wji
wka	f	wka
wkb	f	wkb
wkd	f	wkd
wkl	f	wkl
wku	f	wku
wkw	f	wkw
wky	f	wky
wla	f	wla
wlc	f	wlc
wle	f	wle
wlg	f	wlg
wli	f	wli
wlk	f	wlk
wll	f	wll
wlm	t	wlm
wlo	f	wlo
wlr	f	wlr
wls	f	wls
wlu	f	wlu
wlv	f	wlv
wlw	f	wlw
wlx	f	wlx
wly	f	wly
wmb	f	wmb
wmc	f	wmc
wmd	f	wmd
wme	f	wme
wmh	f	wmh
wmi	f	wmi
wmm	f	wmm
wmn	f	wmn
wmo	f	wmo
wms	f	wms
wmt	f	wmt
wmw	f	wmw
wmx	f	wmx
wnb	f	wnb
wnc	f	wnc
wnd	f	wnd
wne	f	wne
wng	f	wng
wni	f	wni
wnk	f	wnk
wnm	f	wnm
wno	f	wno
wnp	f	wnp
wnu	f	wnu
wnw	f	wnw
wny	f	wny
woa	f	woa
wob	f	wob
woc	f	woc
wod	f	wod
woe	f	woe
wog	f	wog
woi	f	woi
wok	f	wok
wom	f	wom
won	f	won
woo	f	woo
wor	f	wor
wos	f	wos
wow	f	wow
wpc	f	wpc
wra	f	wra
wrb	f	wrb
wrg	f	wrg
wrh	f	wrh
wri	f	wri
wrk	f	wrk
wrl	f	wrl
wrm	f	wrm
wrn	f	wrn
wro	f	wro
wrp	f	wrp
wrr	f	wrr
wrs	f	wrs
wru	f	wru
wrv	f	wrv
wrw	f	wrw
wrx	f	wrx
wrz	f	wrz
wsa	f	wsa
wsi	f	wsi
wsk	f	wsk
wsr	f	wsr
wss	f	wss
wsu	f	wsu
wsv	f	wsv
wtf	f	wtf
wth	f	wth
wti	f	wti
wtk	f	wtk
wtm	f	wtm
wtw	f	wtw
wua	f	wua
wub	f	wub
wud	f	wud
wuh	f	wuh
wul	f	wul
wum	f	wum
wun	f	wun
wur	f	wur
wut	f	wut
wuu	f	wuu
wuv	f	wuv
wux	f	wux
wuy	f	wuy
wwa	f	wwa
wwo	f	wwo
wwr	f	wwr
www	f	www
wxa	f	wxa
wxw	f	wxw
wya	f	wya
wyb	f	wyb
wyi	f	wyi
wym	t	wym
wyr	f	wyr
wyy	f	wyy
xaa	t	xaa
xab	f	xab
xac	f	xac
xad	f	xad
xae	f	xae
xag	f	xag
xai	f	xai
xaj	f	xaj
xak	f	xak
xal	f	xal
xam	f	xam
xan	f	xan
xao	f	xao
xap	f	xap
xaq	f	xaq
xar	f	xar
xas	f	xas
xat	f	xat
xau	f	xau
xav	f	xav
xaw	f	xaw
xay	f	xay
xbb	f	xbb
xbc	t	xbc
xbd	f	xbd
xbe	f	xbe
xbg	f	xbg
xbi	f	xbi
xbj	f	xbj
xbm	f	xbm
xbn	f	xbn
xbo	f	xbo
xbp	f	xbp
xbr	f	xbr
xbw	f	xbw
xby	f	xby
xcb	f	xcb
xcc	f	xcc
xce	f	xce
xch	f	xch
xcl	t	xcl
xcm	f	xcm
xcn	f	xcn
xco	f	xco
xcr	f	xcr
xct	f	xct
xcu	f	xcu
xcv	f	xcv
xcw	f	xcw
xcy	f	xcy
xda	f	xda
xdc	f	xdc
xdk	f	xdk
xdm	f	xdm
xdy	f	xdy
xeb	f	xeb
xed	f	xed
xeg	f	xeg
xel	f	xel
xem	f	xem
xep	f	xep
xer	f	xer
xes	f	xes
xet	f	xet
xeu	f	xeu
xfa	t	xfa
xga	f	xga
xgb	f	xgb
xgd	f	xgd
xgf	f	xgf
xgg	f	xgg
xgi	f	xgi
xgl	f	xgl
xgm	f	xgm
xgr	f	xgr
xgu	f	xgu
xgw	f	xgw
xha	f	xha
xhc	f	xhc
xhd	f	xhd
xhe	f	xhe
xhr	f	xhr
xht	f	xht
xhu	f	xhu
xhv	f	xhv
xib	f	xib
xii	f	xii
xil	f	xil
xin	f	xin
xir	f	xir
xis	f	xis
xiv	f	xiv
xiy	f	xiy
xjb	f	xjb
xka	f	xka
xkb	f	xkb
xkc	f	xkc
xkd	f	xkd
xke	f	xke
xkf	f	xkf
xkg	f	xkg
xki	f	xki
xkj	f	xkj
xkk	f	xkk
xkl	f	xkl
xkn	f	xkn
xko	f	xko
xkp	f	xkp
xkq	f	xkq
xkr	f	xkr
xks	f	xks
xkt	f	xkt
xku	f	xku
xkv	f	xkv
xkw	f	xkw
xkx	f	xkx
xky	f	xky
xkz	f	xkz
xla	f	xla
xlb	f	xlb
xlc	f	xlc
xld	f	xld
xle	f	xle
xlg	f	xlg
xli	f	xli
xlo	f	xlo
xlp	f	xlp
xls	f	xls
xlu	f	xlu
xly	f	xly
xmb	f	xmb
xmc	f	xmc
xmd	f	xmd
xmf	f	xmf
xmg	f	xmg
xmh	f	xmh
xmj	f	xmj
xmk	t	xmk
xml	f	xml
xmm	f	xmm
xmo	f	xmo
xmp	f	xmp
xmq	f	xmq
xmr	f	xmr
xms	f	xms
xmt	f	xmt
xmu	f	xmu
xmx	f	xmx
xmy	f	xmy
xmz	f	xmz
xna	f	xna
xnb	f	xnb
xng	f	xng
xnh	f	xnh
xni	f	xni
xnk	f	xnk
xnn	f	xnn
xnr	f	xnr
xns	f	xns
xnt	f	xnt
xnu	f	xnu
xny	f	xny
xoc	f	xoc
xod	f	xod
xog	f	xog
xoi	f	xoi
xok	f	xok
xom	f	xom
xon	f	xon
xoo	f	xoo
xop	f	xop
xor	f	xor
xow	f	xow
xpa	f	xpa
xpb	f	xpb
xpc	f	xpc
xpd	f	xpd
xpe	f	xpe
xpf	f	xpf
xpg	f	xpg
xph	f	xph
xpi	f	xpi
xpj	f	xpj
xpk	f	xpk
xpl	f	xpl
xpm	f	xpm
xpn	f	xpn
xpo	f	xpo
xpp	f	xpp
xpq	f	xpq
xpr	f	xpr
xps	f	xps
xpu	f	xpu
xpv	f	xpv
xpw	f	xpw
xpx	f	xpx
xpy	f	xpy
xpz	f	xpz
xqa	f	xqa
xqt	f	xqt
xra	f	xra
xrb	f	xrb
xrd	f	xrd
xre	f	xre
xrg	f	xrg
xri	f	xri
xrm	f	xrm
xrn	f	xrn
xrq	f	xrq
xrr	f	xrr
xrt	f	xrt
xru	f	xru
xrw	f	xrw
xsa	f	xsa
xsb	f	xsb
xsd	f	xsd
xse	f	xse
xsh	f	xsh
xsi	f	xsi
xsj	f	xsj
xsl	f	xsl
xsm	f	xsm
xsn	f	xsn
xso	f	xso
xsp	f	xsp
xsq	f	xsq
xsr	f	xsr
xss	f	xss
xsu	f	xsu
xsv	f	xsv
xsy	f	xsy
xta	f	xta
xtb	f	xtb
xtc	f	xtc
xtd	f	xtd
xte	f	xte
xth	f	xth
xti	f	xti
xtj	f	xtj
xtl	f	xtl
xtm	f	xtm
xtn	f	xtn
xto	f	xto
xtp	f	xtp
xtq	f	xtq
xtr	f	xtr
xts	f	xts
xtt	f	xtt
xtu	f	xtu
xtv	f	xtv
xtw	f	xtw
xty	f	xty
xtz	f	xtz
xua	f	xua
xub	f	xub
xud	f	xud
xug	f	xug
xuj	f	xuj
xul	f	xul
xum	f	xum
xun	f	xun
xuo	f	xuo
xup	f	xup
xur	f	xur
xut	f	xut
xuu	f	xuu
xve	f	xve
xvn	f	xvn
xvo	f	xvo
xvs	f	xvs
xwa	f	xwa
xwc	f	xwc
xwd	f	xwd
xwe	f	xwe
xwg	f	xwg
xwj	f	xwj
xwk	f	xwk
xwl	f	xwl
xwo	f	xwo
xwr	f	xwr
xww	f	xww
xxb	f	xxb
xxk	f	xxk
xxm	f	xxm
xxr	f	xxr
xxt	f	xxt
xya	f	xya
xyb	f	xyb
xyl	f	xyl
xyt	f	xyt
xyy	f	xyy
xzh	f	xzh
xzm	f	xzm
xzp	f	xzp
yaa	f	yaa
yab	f	yab
yac	f	yac
yad	f	yad
yae	f	yae
yaf	f	yaf
yag	f	yag
yah	f	yah
yai	f	yai
yaj	f	yaj
yak	f	yak
yal	f	yal
yam	f	yam
yan	f	yan
yao	f	yao
yap	f	yap
yaq	f	yaq
yar	f	yar
yas	f	yas
yat	f	yat
yau	f	yau
yav	f	yav
yaw	f	yaw
yay	f	yay
yaz	f	yaz
yba	f	yba
ybb	f	ybb
ybe	f	ybe
ybh	f	ybh
ybi	f	ybi
ybj	f	ybj
ybk	f	ybk
ybl	f	ybl
ybm	f	ybm
ybn	f	ybn
ybo	f	ybo
ybx	f	ybx
yby	f	yby
ych	f	ych
ycl	f	ycl
ycn	f	ycn
ycp	f	ycp
yda	f	yda
yde	f	yde
ydg	f	ydg
ydk	f	ydk
yea	f	yea
yec	f	yec
yee	f	yee
yei	f	yei
yej	t	yej
yen	f	yen
yer	f	yer
yes	f	yes
yet	f	yet
yeu	f	yeu
yev	f	yev
yey	f	yey
ygi	f	ygi
ygl	f	ygl
ygm	f	ygm
ygp	f	ygp
ygr	f	ygr
ygs	f	ygs
ygu	f	ygu
ygw	f	ygw
yha	f	yha
yhl	f	yhl
yia	f	yia
yif	f	yif
yig	f	yig
yii	f	yii
yij	f	yij
yik	f	yik
yil	f	yil
yim	f	yim
yin	f	yin
yip	f	yip
yiq	f	yiq
yir	f	yir
yis	f	yis
yit	f	yit
yiu	f	yiu
yiv	f	yiv
yix	f	yix
yiy	f	yiy
yiz	f	yiz
yka	f	yka
ykg	f	ykg
yki	f	yki
ykk	f	ykk
ykl	f	ykl
ykm	f	ykm
ykn	f	ykn
yko	f	yko
ykr	f	ykr
ykt	f	ykt
yku	f	yku
yky	f	yky
yla	f	yla
ylb	f	ylb
yle	f	yle
ylg	f	ylg
yli	f	yli
yll	f	yll
ylm	f	ylm
yln	f	yln
ylo	f	ylo
ylr	f	ylr
ylu	f	ylu
yly	f	yly
ymb	f	ymb
ymc	f	ymc
ymd	f	ymd
yme	f	yme
ymg	f	ymg
ymh	f	ymh
ymi	f	ymi
ymk	f	ymk
yml	f	yml
ymm	f	ymm
ymn	f	ymn
ymo	f	ymo
ymp	f	ymp
ymq	f	ymq
ymr	f	ymr
yms	f	yms
ymx	f	ymx
ymz	f	ymz
yna	f	yna
ynd	f	ynd
yne	f	yne
yng	f	yng
ynk	f	ynk
ynl	f	ynl
ynn	f	ynn
yno	f	yno
yns	f	yns
ynu	f	ynu
yob	f	yob
yog	f	yog
yoi	f	yoi
yol	f	yol
yom	f	yom
yon	f	yon
yox	f	yox
yoy	f	yoy
ypa	f	ypa
ypb	f	ypb
ypg	f	ypg
yph	f	yph
ypm	f	ypm
ypn	f	ypn
ypo	f	ypo
ypp	f	ypp
ypz	f	ypz
yra	f	yra
yrb	f	yrb
yre	f	yre
yri	f	yri
yrk	t	yrk
yrl	f	yrl
yrn	f	yrn
yro	f	yro
yrw	f	yrw
yry	f	yry
ysc	f	ysc
ysd	f	ysd
ysg	f	ysg
ysl	f	ysl
ysn	f	ysn
yso	f	yso
ysp	f	ysp
ysr	f	ysr
yss	f	yss
ysy	f	ysy
yta	f	yta
ytl	f	ytl
ytp	f	ytp
ytw	f	ytw
yty	f	yty
yua	f	yua
yub	f	yub
yuc	f	yuc
yue	f	yue
yuf	f	yuf
yug	f	yug
yui	f	yui
yuj	f	yuj
yuk	f	yuk
yul	f	yul
yum	f	yum
yun	f	yun
yup	f	yup
yuq	f	yuq
yur	f	yur
yut	f	yut
yuw	f	yuw
yux	f	yux
yuy	f	yuy
yuz	f	yuz
yva	f	yva
yvt	f	yvt
ywa	f	ywa
ywg	f	ywg
ywl	f	ywl
ywn	f	ywn
ywq	f	ywq
ywr	f	ywr
ywt	f	ywt
ywu	f	ywu
yww	f	yww
yxa	f	yxa
yxg	f	yxg
yxl	f	yxl
yxm	f	yxm
yxu	f	yxu
yxy	f	yxy
yyu	f	yyu
yyz	f	yyz
yzg	f	yzg
yzk	f	yzk
zaa	f	zaa
zab	f	zab
zac	f	zac
zad	f	zad
zae	f	zae
zaf	f	zaf
zag	f	zag
zah	f	zah
zai	f	zai
zaj	f	zaj
zak	f	zak
zal	f	zal
zam	f	zam
zao	f	zao
zap	f	zap
zaq	f	zaq
zar	f	zar
zas	f	zas
zat	f	zat
zau	f	zau
zav	f	zav
zaw	f	zaw
zax	f	zax
zay	f	zay
zaz	f	zaz
zbt	f	zbt
zca	f	zca
zdj	f	zdj
zea	f	zea
zeg	f	zeg
zen	f	zen
zga	f	zga
zgh	f	zgh
zgr	f	zgr
zhb	f	zhb
zhi	f	zhi
zhn	f	zhn
zhw	f	zhw
zia	f	zia
zib	f	zib
zik	f	zik
zil	f	zil
zim	f	zim
zin	f	zin
zir	f	zir
ziw	f	ziw
ziz	f	ziz
zka	f	zka
zkb	f	zkb
zkg	f	zkg
zkh	f	zkh
zkk	f	zkk
zko	f	zko
zkp	f	zkp
zkr	f	zkr
zkt	f	zkt
zku	f	zku
zkv	f	zkv
zkz	f	zkz
zma	f	zma
zmb	f	zmb
zmc	f	zmc
zmd	f	zmd
zme	f	zme
zmf	f	zmf
zmg	f	zmg
zmh	f	zmh
zmi	f	zmi
zmj	f	zmj
zmk	f	zmk
zml	f	zml
zmm	f	zmm
zmn	f	zmn
zmo	f	zmo
zmp	f	zmp
zmq	f	zmq
zmr	f	zmr
zms	f	zms
zmt	f	zmt
zmu	f	zmu
zmv	f	zmv
zmw	f	zmw
zmx	f	zmx
zmy	f	zmy
zmz	f	zmz
zna	f	zna
zne	f	znd
zng	f	zng
znk	f	znk
zns	f	zns
zoc	f	zoc
zoh	f	zoh
zom	f	zom
zoo	f	zoo
zoq	f	zoq
zor	f	zor
zos	f	zos
zpa	f	zpa
zpb	f	zpb
zpc	f	zpc
zpd	f	zpd
zpe	f	zpe
zpf	f	zpf
zpg	f	zpg
zph	f	zph
zpi	f	zpi
zpj	f	zpj
zpk	f	zpk
zpl	f	zpl
zpm	f	zpm
zpn	f	zpn
zpo	f	zpo
zpp	f	zpp
zpq	f	zpq
zpr	f	zpr
zps	f	zps
zpt	f	zpt
zpu	f	zpu
zpv	f	zpv
zpw	f	zpw
zpx	f	zpx
zpy	f	zpy
zpz	f	zpz
zra	f	zra
zrg	f	zrg
zrn	f	zrn
zro	f	zro
zrs	f	zrs
zsa	f	zsa
zsk	f	zsk
zsl	f	zsl
zsr	f	zsr
zsu	f	zsu
zte	f	zte
ztg	f	ztg
ztl	f	ztl
ztm	f	ztm
ztn	f	ztn
ztp	f	ztp
ztq	f	ztq
zts	f	zts
ztt	f	ztt
ztu	f	ztu
ztx	f	ztx
zty	f	zty
zua	f	zua
zuh	f	zuh
zum	f	zum
zun	f	zun
zuy	f	zuy
zwa	f	zwa
zyp	f	zyp
zza	f	zza
zzj	f	zzj
aav-khs-pro	f	aav-khs-pro
aav-nic-pro	f	aav-nic-pro
aav-pkl-pro	f	aav-pkl-pro
aav-pro	f	aav-pro
afa-pro	f	afa-pro
alg-aga	f	alg-aga
alg-pro	f	alg-pro
alv-ama	t	alv-ama
alv-bgu	f	alv-bgu
alv-bua-pro	f	alv-bua-pro
alv-cng-pro	f	alv-cng-pro
alv-edo-pro	f	alv-edo-pro
alv-fli-pro	f	alv-fli-pro
alv-gbe-pro	f	alv-gbe-pro
alv-gng-pro	f	alv-gng-pro
alv-gtm-pro	f	alv-gtm-pro
alv-gwa	f	alv-gwa
alv-hei-pro	f	alv-hei-pro
alv-ido-pro	f	alv-ido-pro
alv-igb-pro	f	alv-igb-pro
alv-kwa-pro	f	alv-kwa-pro
alv-mum-pro	f	alv-mum-pro
alv-nup-pro	f	alv-nup-pro
alv-pro	f	alv-pro
alv-yor-pro	f	alv-yor-pro
apa-pro	f	apa-pro
aql-pro	f	aql-pro
art-blk	f	art-blk
art-bsp	f	art-bsp
art-com	f	art-com
art-dtk	f	art-dtk
art-elo	f	art-elo
art-gld	f	art-gld
art-lap	f	art-lap
art-man	f	art-man
art-mun	f	art-mun
art-nav	f	art-nav
art-nox	f	art-nox
art-una	f	art-una
ath-nic	f	ath-nic
ath-pro	f	ath-pro
auf-pro	f	auf-pro
aus-alu	f	aus-alu
aus-and	f	aus-and
aus-ang	f	aus-ang
aus-arn-pro	f	aus-arn-pro
aus-bra	f	aus-bra
aus-brm	f	aus-brm
aus-cww-pro	f	aus-cww-pro
aus-dal-pro	f	aus-dal-pro
aus-guw	f	aus-guw
aus-lsw	f	aus-lsw
aus-mbi	f	aus-mbi
aus-ngk	f	aus-ngk
aus-nyu-pro	f	aus-nyu-pro
aus-pam-pro	f	aus-pam-pro
aus-tul	f	aus-tul
aus-uwi	f	aus-uwi
aus-wdj-pro	f	aus-wdj-pro
aus-won	f	aus-won
aus-wul	f	aus-wul
aus-ynk	f	aus-ynk
awd-ama	f	awd-ama
awd-amc-pro	f	awd-amc-pro
awd-ana	f	awd-ana
awd-apo	f	awd-apo
awd-cav	f	awd-cav
awd-gnu	f	awd-gnu
awd-kar	f	awd-kar
awd-kaw	f	awd-kaw
awd-kmp-pro	f	awd-kmp-pro
awd-kus	f	awd-kus
awd-man	f	awd-man
awd-mar	f	awd-mar
awd-mpr	f	awd-mpr
awd-mrt	f	awd-mrt
awd-nwk-pro	f	awd-nwk-pro
awd-pai	f	awd-pai
awd-pas	f	awd-pas
awd-pro	f	awd-pro
awd-prw-pro	f	awd-prw-pro
awd-she	f	awd-she
awd-taa-pro	f	awd-taa-pro
awd-wai	f	awd-wai
awd-yum	f	awd-yum
azc-caz	f	azc-caz
azc-cup-pro	f	azc-cup-pro
azc-ktn	f	azc-ktn
azc-nah-pro	f	azc-nah-pro
azc-num-pro	f	azc-num-pro
azc-pro	f	azc-pro
azc-tak-pro	f	azc-tak-pro
azc-tat	f	azc-tat
ber-fog	f	ber-fog
ber-pro	f	ber-pro
ber-zuw	f	ber-zuw
bnt-bal	f	bnt-bal
bnt-bon	f	bnt-bon
bnt-boy	f	bnt-boy
bnt-bwa	f	bnt-bwa
bnt-cmw	f	bnt-cmw
bnt-ind	f	bnt-ind
bnt-lal	f	bnt-lal
bnt-lwl	f	bnt-lwl
bnt-mpi	f	bnt-mpi
bnt-mpu	f	bnt-mpu
bnt-ngu-pro	f	bnt-ngu-pro
bnt-phu	t	bnt-phu
bnt-pro	f	bnt-pro
bnt-sbo	f	bnt-sbo
bnt-sts-pro	f	bnt-sts-pro
btk-pro	f	btk-pro
cau-abz-pro	f	cau-abz-pro
cau-ava-pro	f	cau-ava-pro
cau-cir-pro	f	cau-cir-pro
cau-drg-pro	f	cau-drg-pro
cau-lzg-pro	f	cau-lzg-pro
cau-nec-pro	f	cau-nec-pro
cau-nkh-pro	f	cau-nkh-pro
cau-nwc-pro	f	cau-nwc-pro
cau-tsz-pro	f	cau-tsz-pro
cba-ata	f	cba-ata
cba-cat	f	cba-cat
cba-dor	f	cba-dor
cba-dui	f	cba-dui
cba-hue	f	cba-hue
cba-nut	f	cba-nut
cba-pro	f	cba-pro
ccn-pro	f	ccn-pro
ccs-gzn-pro	t	ccs-gzn-pro
ccs-pro	t	ccs-pro
cdc-cbm-pro	f	cdc-cbm-pro
cdc-mas-pro	f	cdc-mas-pro
cdc-pro	f	cdc-pro
cdd-pro	f	cdd-pro
cel-bry-pro	f	cel-bry-pro
cel-gal	f	cel-gal
cel-gau	t	cel-gau
cel-pro	f	cel-pro
chi-pro	f	chi-pro
cmc-pro	f	cmc-pro
cpe-mar	f	cpe-mar
cpe-spp	f	cpe-spp
crp-gep	f	crp-gep
crp-mpp	f	crp-mpp
crp-rsn	f	crp-rsn
crp-tpr	f	crp-tpr
csu-bba-pro	f	csu-bba-pro
csu-maa-pro	f	csu-maa-pro
csu-pro	f	csu-pro
csu-sar-pro	f	csu-sar-pro
ctp-san	f	ctp-san
cus-ash	f	cus-ash
cus-hec-pro	f	cus-hec-pro
cus-pro	f	cus-pro
dmn-dam	f	dmn-dam
dmn-mdw-pro	f	dmn-mdw-pro
dmn-pro	f	dmn-pro
dra-mkn	f	dra-mkn
dra-okn	f	dra-okn
dra-pro	f	dra-pro
dru-pro	f	dru-pro
egx-dem	f	egx-dem
elu-prk	f	elu-prk
esx-esk-pro	f	esx-esk-pro
esx-ink	f	esx-ink
esx-inq	f	esx-inq
esx-inu-pro	f	esx-inu-pro
esx-pro	f	esx-pro
esx-tut	f	esx-tut
euq-pro	f	euq-pro
fiu-fin-pro	f	fiu-fin-pro
gem-bur	f	gem-bur
gem-pro	f	gem-pro
gme-cgo	f	gme-cgo
gmq-bot	f	gmq-bot
gmq-gut	f	gmq-gut
gmq-jmk	f	gmq-jmk
gmq-mno	f	gmq-mno
gmq-oda	t	gmq-oda
gmq-osw	t	gmq-osw
gmq-pro	f	gmq-pro
gmq-scy	f	gmq-scy
gmw-bgh	f	gmw-bgh
gmw-cfr	f	gmw-cfr
gmw-ecg	f	gmw-ecg
gmw-gts	f	gmw-gts
gmw-jdt	f	gmw-jdt
gmw-pro	f	gmw-pro
gmw-rfr	f	gmw-rfr
gmw-stm	f	gmw-stm
gmw-tsx	f	gmw-tsx
gmw-vog	f	gmw-vog
gmw-zps	f	gmw-zps
grk-cal	f	grk-cal
grk-ita	f	grk-ita
grk-mar	t	grk-mar
grk-pro	f	grk-pro
hmn-pro	f	hmn-pro
hmx-mie-pro	f	hmx-mie-pro
hmx-pro	f	hmx-pro
hyx-pro	f	hyx-pro
iir-nur-pro	f	iir-nur-pro
iir-pro	f	iir-pro
ijo-pro	f	ijo-pro
inc-ash	f	inc-ash
inc-cen-pro	f	inc-cen-pro
inc-gup	f	inc-gup
inc-kam	f	inc-kam
inc-kha	f	inc-kha
inc-kho	f	inc-kho
inc-mas	f	inc-mas
inc-mbn	f	inc-mbn
inc-mgd	f	inc-mgd
inc-mgu	f	inc-mgu
inc-mor	f	inc-mor
inc-oas	f	inc-oas
inc-obn	f	inc-obn
inc-ogu	f	inc-ogu
inc-ohi	f	inc-ohi
inc-oor	f	inc-oor
inc-opa	t	inc-opa
inc-ork	f	inc-ork
inc-pra	t	pra
inc-pro	f	inc-pro
inc-psc	f	inc-psc
inc-sap	f	inc-sap
inc-tak	f	inc-tak
inc-vra	f	inc-vra
ine-ana-pro	f	ine-ana-pro
ine-bsl-pro	f	ine-bsl-pro
ine-pae	t	ine-pae
ine-pro	f	ine-pro
ine-toc-pro	f	ine-toc-pro
ira-kms-pro	f	ira-kms-pro
ira-mny-pro	f	ira-mny-pro
ira-mpr-pro	f	ira-mpr-pro
ira-pat-pro	f	ira-pat-pro
ira-pro	f	ira-pro
ira-sgc-pro	f	ira-sgc-pro
ira-sgi-pro	f	ira-sgi-pro
ira-shr-pro	f	ira-shr-pro
ira-shy-pro	f	ira-shy-pro
ira-sym-pro	f	ira-sym-pro
ira-wnj	f	ira-wnj
ira-zgr-pro	f	ira-zgr-pro
iro-ere	f	iro-ere
iro-min	f	iro-min
iro-pro	f	iro-pro
itc-ola	t	itc-ola
itc-pro	f	itc-pro
jpx-pro	f	jpx-pro
jpx-ryu-pro	f	jpx-ryu-pro
kar-pro	f	kar-pro
khi-kho-pro	f	khi-kho-pro
khi-kun	f	khi-kun
ko-ear	f	ko-ear
kro-pro	f	kro-pro
ku-pro	f	ku-pro
map-ata-pro	f	map-ata-pro
map-bms	f	map-bms
map-pro	f	map-pro
mkh-asl-pro	f	mkh-asl-pro
mkh-ban-pro	f	mkh-ban-pro
mkh-kat-pro	f	mkh-kat-pro
mkh-khm-pro	f	mkh-khm-pro
mkh-kmr-pro	f	mkh-kmr-pro
mkh-mkm	f	mkh-mkm
mkh-mmn	f	mkh-mmn
mkh-mnc-pro	f	mkh-mnc-pro
mkh-mvi	f	mkh-mvi
mkh-okm	f	mkh-okm
mkh-pal-pro	f	mkh-pal-pro
mkh-pea-pro	f	mkh-pea-pro
mkh-pkn-pro	f	mkh-pkn-pro
mkh-pro	f	mkh-pro
mkh-vie-pro	f	mkh-vie-pro
mun-pro	f	mun-pro
myn-chl	f	myn-chl
myn-pro	f	myn-pro
nai-ala	f	nai-ala
nai-bay	f	nai-bay
nai-bvy	f	nai-bvy
nai-cal	f	nai-cal
nai-chi	f	nai-chi
nai-chu-pro	f	nai-chu-pro
nai-cig	f	nai-cig
nai-ckn-pro	f	nai-ckn-pro
nai-dly	f	nai-dly
nai-gsy	f	nai-gsy
nai-guz	f	nai-guz
nai-hit	f	nai-hit
nai-ipa	f	nai-ipa
nai-jtp	f	nai-jtp
nai-jum	f	nai-jum
nai-kat	f	nai-kat
nai-klp-pro	f	nai-klp-pro
nai-knm	f	nai-knm
nai-kry	f	nai-kry
nai-kum	f	nai-kum
nai-mac	f	nai-mac
nai-mdu-pro	f	nai-mdu-pro
nai-miz-pro	f	nai-miz-pro
nai-nao	f	nai-nao
nai-nrs	f	nai-nrs
nai-nvy	f	nai-nvy
nai-okw	f	nai-okw
nai-per	f	nai-per
nai-pic	f	nai-pic
nai-plp-pro	f	nai-plp-pro
nai-ply	f	nai-ply
nai-pom-pro	f	nai-pom-pro
nai-qng	f	nai-qng
nai-sca-pro	f	nai-sca-pro
nai-sin	f	nai-sin
nai-sln	f	nai-sln
nai-spt	f	nai-spt
nai-svy	f	nai-svy
nai-tap	f	nai-tap
nai-taw	f	nai-taw
nai-teq	f	nai-teq
nai-tip	f	nai-tip
nai-tky	f	nai-tky
nai-tot-pro	f	nai-tot-pro
nai-tsi-pro	f	nai-tsi-pro
nai-utn-pro	f	nai-utn-pro
nai-wai	f	nai-wai
nai-yup	f	nai-yup
nds-de	f	nds-de
nds-nl	f	nds-nl
ngf-pro	f	ngf-pro
nic-bco-pro	f	nic-bco-pro
nic-bod-pro	f	nic-bod-pro
nic-eov-pro	f	nic-eov-pro
nic-gns-pro	f	nic-gns-pro
nic-grf-pro	f	nic-grf-pro
nic-gur-pro	f	nic-gur-pro
nic-jkn-pro	f	nic-jkn-pro
nic-lcr-pro	f	nic-lcr-pro
nic-ogo-pro	f	nic-ogo-pro
nic-ovo-pro	f	nic-ovo-pro
nic-plt-pro	f	nic-plt-pro
nic-pro	f	nic-pro
nic-ubg-pro	f	nic-ubg-pro
nic-ucr-pro	f	nic-ucr-pro
nic-vco-pro	f	nic-vco-pro
nub-har	f	nub-har
nub-pro	f	nub-pro
omq-cha-pro	f	omq-cha-pro
omq-maz-pro	f	omq-maz-pro
omq-mix-pro	f	omq-mix-pro
omq-mxt-pro	f	omq-mxt-pro
omq-otp-pro	f	omq-otp-pro
omq-pro	f	omq-pro
omq-tel	f	omq-tel
omq-teo	f	omq-teo
omq-tri-pro	f	omq-tri-pro
omq-zap-pro	f	omq-zap-pro
omq-zpc-pro	f	omq-zpc-pro
omv-aro-pro	f	omv-aro-pro
omv-diz-pro	f	omv-diz-pro
omv-pro	f	omv-pro
os-pro	f	os-pro
oto-otm-pro	f	oto-otm-pro
oto-pro	f	oto-pro
paa-kom	f	paa-kom
paa-kwn	f	paa-kwn
paa-nha-pro	f	paa-nha-pro
paa-nun	f	paa-nun
phi-din	f	phi-din
phi-kal-pro	f	phi-kal-pro
phi-nag	f	phi-nag
phi-pro	f	phi-pro
poz-abi	f	poz-abi
poz-bal	f	poz-bal
poz-btk-pro	f	poz-btk-pro
poz-cet-pro	f	poz-cet-pro
poz-hce-pro	f	poz-hce-pro
poz-lgx-pro	f	poz-lgx-pro
poz-mcm-pro	f	poz-mcm-pro
poz-mly-pro	f	poz-mly-pro
poz-msa-pro	f	poz-msa-pro
poz-oce-pro	f	poz-oce-pro
poz-pep-pro	f	poz-pep-pro
poz-pnp-pro	f	poz-pnp-pro
poz-pol-pro	f	poz-pol-pro
poz-pro	f	poz-pro
poz-ssw-pro	f	poz-ssw-pro
poz-sus-pro	f	poz-sus-pro
poz-swa-pro	f	poz-swa-pro
pqe-pro	f	pqe-pro
pra-niy	f	pra-niy
qfa-adm-pro	f	qfa-adm-pro
qfa-bet-pro	f	qfa-bet-pro
qfa-cka-pro	f	qfa-cka-pro
qfa-hur-pro	f	qfa-hur-pro
qfa-kad-pro	f	qfa-kad-pro
qfa-kms-pro	f	qfa-kms-pro
qfa-kor-pro	f	qfa-kor-pro
qfa-kra-pro	f	qfa-kra-pro
qfa-lic-pro	f	qfa-lic-pro
qfa-onb-pro	f	qfa-onb-pro
qfa-ong-pro	f	qfa-ong-pro
qfa-tak-pro	f	qfa-tak-pro
qfa-yen-pro	f	qfa-yen-pro
qfa-yuk-pro	f	qfa-yuk-pro
qwe-kch	f	qwe-kch
roa-ang	f	roa-ang
roa-bbn	f	roa-bbn
roa-brg	f	roa-brg
roa-cha	f	roa-cha
roa-fcm	f	roa-fcm
roa-gal	f	roa-gal
roa-leo	f	roa-leo
roa-lor	f	roa-lor
roa-oan	f	roa-oan
roa-oca	f	roa-oca
roa-ole	f	roa-ole
roa-opt	f	roa-opt
roa-orl	f	roa-orl
roa-poi	f	roa-poi
roa-tar	f	roa-tar
roa-tou	f	roa-tou
sai-ajg	f	sai-ajg
sai-all	f	sai-all
sai-and	f	sai-and
sai-ayo	f	sai-ayo
sai-bae	f	sai-bae
sai-bag	f	sai-bag
sai-bet	f	sai-bet
sai-bor-pro	f	sai-bor-pro
sai-cac	f	sai-cac
sai-caq	f	sai-caq
sai-cat	f	sai-cat
sai-cer-pro	f	sai-cer-pro
sai-chi	f	sai-chi
sai-chn	f	sai-chn
sai-chp	f	sai-chp
sai-chr	f	sai-chr
sai-chu	f	sai-chu
sai-cje-pro	f	sai-cje-pro
sai-cmg	f	sai-cmg
sai-cno	f	sai-cno
sai-cnr	f	sai-cnr
sai-coe	f	sai-coe
sai-col	f	sai-col
sai-cop	f	sai-cop
sai-crd	f	sai-crd
sai-ctq	f	sai-ctq
sai-cul	f	sai-cul
sai-cva	f	sai-cva
sai-esm	f	sai-esm
sai-ewa	f	sai-ewa
sai-gam	f	sai-gam
sai-gay	f	sai-gay
sai-gmo	f	sai-gmo
sai-gue	f	sai-gue
sai-hau	f	sai-hau
sai-hoc-pro	f	sai-hoc-pro
sai-jee-pro	f	sai-jee-pro
sai-jko	f	sai-jko
sai-jrj	f	sai-jrj
sai-kat	f	sai-kat
sai-mal	f	sai-mal
sai-mar	f	sai-mar
sai-mat	f	sai-mat
sai-mcn	f	sai-mcn
sai-men	f	sai-men
sai-mil	f	sai-mil
sai-mlb	f	sai-mlb
sai-msk	f	sai-msk
sai-muc	f	sai-muc
sai-mue	f	sai-mue
sai-muz	f	sai-muz
sai-mys	f	sai-mys
sai-nat	f	sai-nat
sai-nje-pro	f	sai-nje-pro
sai-opo	f	sai-opo
sai-oto	f	sai-oto
sai-pal	f	sai-pal
sai-pam	f	sai-pam
sai-par	f	sai-par
sai-pnz	f	sai-pnz
sai-prh	f	sai-prh
sai-ptg	f	sai-ptg
sai-pur	f	sai-pur
sai-pyg	f	sai-pyg
sai-pyk	f	sai-pyk
sai-qmb	f	sai-qmb
sai-qtm	f	sai-qtm
sai-rab	f	sai-rab
sai-ram	f	sai-ram
sai-sac	f	sai-sac
sai-san	f	sai-san
sai-sap	f	sai-sap
sai-sec	f	sai-sec
sai-sin	f	sai-sin
sai-sje-pro	f	sai-sje-pro
sai-tab	f	sai-tab
sai-tal	f	sai-tal
sai-tap	f	sai-tap
sai-teu	f	sai-teu
sai-tim	f	sai-tim
sai-tpr	f	sai-tpr
sai-trr	f	sai-trr
sai-wai	f	sai-wai
sai-way	f	sai-way
sai-wit-pro	f	sai-wit-pro
sai-wnm	f	sai-wnm
sai-xoc	f	sai-xoc
sai-yao	f	sai-yao
sai-yar	f	sai-yar
sai-yri	f	sai-yri
sai-yup	f	sai-yup
sai-yur	f	sai-yur
sal-pro	f	sal-pro
sdv-daj-pro	f	sdv-daj-pro
sdv-eje-pro	f	sdv-eje-pro
sdv-nil-pro	f	sdv-nil-pro
sdv-nyi-pro	f	sdv-nyi-pro
sdv-tmn-pro	f	sdv-tmn-pro
sem-amm	f	sem-amm
sem-amo	f	sem-amo
sem-cha	f	sem-cha
sem-dad	f	sem-dad
sem-dum	f	sem-dum
sem-has	f	sem-has
sem-him	f	sem-him
sem-his	f	sem-his
sem-mhr	f	sem-mhr
sem-pro	f	sem-pro
sem-saf	f	sem-saf
sem-srb	f	sem-osa
sem-tay	f	sem-tay
sem-tha	f	sem-tha
sem-wes-pro	f	sem-wes-pro
sio-pro	f	sio-pro
sit-bok	f	sit-bok
sit-cha	f	sit-cha
sit-gkh	f	sit-gkh
sit-hrs-pro	f	sit-hrs-pro
sit-jap	f	sit-jap
sit-kha-pro	f	sit-kha-pro
sit-liz	f	sit-liz
sit-luu-pro	f	sit-luu-pro
sit-mor	f	sit-mor
sit-prn	f	sit-prn
sit-pro	f	sit-pro
sit-sit	f	sit-sit
sit-tan-pro	f	sit-tan-pro
sit-tgm	f	sit-tgm
sit-tos	f	sit-tos
sit-tsh	f	sit-tsh
sit-zbu	f	sit-zbu
sla-pro	t	sla-pro
smi-pro	f	smi-pro
son-pro	f	son-pro
sqj-pro	f	sqj-pro
ssa-klk-pro	f	ssa-klk-pro
ssa-kom-pro	f	ssa-kom-pro
ssa-pro	f	ssa-pro
syd-fne	t	syd-fne
syd-pro	f	syd-pro
tai-pro	f	tai-pro
tai-swe-pro	f	tai-swe-pro
tbq-bdg-pro	f	tbq-bdg-pro
tbq-kuk-pro	f	tbq-kuk-pro
tbq-lal-pro	f	tbq-lal-pro
tbq-laz	f	tbq-laz
tbq-lob-pro	f	tbq-lob-pro
tbq-lol-pro	f	tbq-lol-pro
tbq-ngo	f	tbq-ngo
tbq-plg	f	tbq-plg
trk-dkh	f	trk-dkh
trk-oat	f	trk-oat
trk-pro	f	trk-pro
tup-gua-pro	f	tup-gua-pro
tup-kab	f	tup-kab
tup-pro	f	tup-pro
tuw-pro	f	tuw-pro
tuw-sol	f	tuw-sol
und-isa	f	und-isa
und-kas	f	und-kas
und-mil	f	und-mil
und-mmd	f	und-mmd
und-mmn	f	und-mmn
und-phi	f	und-phi
und-wji	f	und-wji
urj-mdv-pro	f	urj-mdv-pro
urj-prm-pro	f	urj-prm-pro
urj-pro	f	urj-pro
urj-ugr-pro	f	urj-ugr-pro
xgn-kha	f	xgn-kha
xgn-mgl	f	mjg-huz
xgn-mgr	f	mjg-min
xgn-pro	f	xgn-pro
xme-ker	f	xme-ker
xme-kls	f	xme-kls
xme-klt	f	xme-klt
xme-mid	f	xme-mid
xme-old	f	xme-old
xme-ott	f	xme-ott
xme-taf	f	xme-taf
xme-ttc-pro	f	xme-ttc-pro
xnd-pro	f	xnd-pro
xsc-pro	f	xsc-pro
xsc-sak-pro	f	xsc-sak-pro
xsc-skw-pro	f	xsc-skw-pro
ypk-pro	f	ypk-pro
zhx-min-pro	f	zhx-min-pro
zhx-sht	f	zhx-sht
zhx-tai	f	zhx-tai
zhx-teo	f	zhx-teo
zle-ono	t	zle-ono
zlw-ocs	f	zlw-ocs
zlw-opl	f	zlw-opl
zlw-pom	f	zlw-pom
zlw-slv	f	zlw-slv
abh-prk	t	pra
xme-abz	f	xme-ker
xme-aby	f	xme-ker
Acadian French	f	fr
fr-aca	f	fr
fra-aca	f	fr
elx-ach	f	elx
add-dv	f	dv
grc-aeo	t	grc
ps-afr	f	ps-nea
cop-akh	t	cop
xln	f	oos
AE.	f	en
American English	f	en
en-US	f	en
xme-amo	f	xme-taf
nan-xm	f	nan-hok
xme-ana	f	xme-ker
tly-anb	f	tly-nor
mkh-okm-A	f	mkh-okm
ang-ang	t	ang
xno	f	fro
oc-ara	f	oc-gas
aae	t	sq
grc-arc	f	grc-arp
grc-arp	t	grc
xme-ard	f	xme-ker
inc-pka	t	pra
klj-arg	f	klj
qwm-arm	f	qwm
aat	t	sq
tly-asa	f	tly-cen
atn	f	xme-taf
xme-ast	f	xme-taf
grc-att	t	grc
AG.	f	de
Austrian German	f	de
de-AT	f	de
oc-auv	f	oc
prk-avt	t	pra
tly-aze	f	tly-nor
xme-bdr	f	xme-ker
bhl-prk	t	pra
sgh-baj	f	sgh-xgb
bsg-ban	f	bsg
ps-bng	f	ps-nea
ps-ban	f	ps-sea
sgh-bar	f	sgh-bro
sgh-bro	f	sgh
bsg-bas	f	bsg
pse-bsm	f	pse
bew-kot	f	bew
bew-ora	f	bew
bew-udi	f	bew
arc-bib	t	arc
hbo	t	he
xme-bid	f	xme-ker
xme-bij	f	xme-ker
grc-boi	f	grc-aeo
cop-boh	t	cop
hi-mum	f	hi
gax	f	om
xme-bor	f	xme-taf
sa-bra	t	sa
pt-BR	f	pt
BE.	f	en
British English	f	en
en-GB	f	en
sa-bhs	t	sa
fay-bur	f	fay
fay-bsh	f	fay
Medieval Greek	t	grc
gkm	t	grc
frc	f	fr
ncb-cam	f	ncb
sc-sro	f	sc
CF.	f	fr
Canadian French	f	fr
fr-CA	f	fr
cnd-prk	t	pra
ps-cgi	f	ps-nwe
ko-c	t	ko
tly-cen	f	tly
xme-ttc-cen	f	xme-ott
ckm	t	sh
sh-cha	t	sh
mn-cha	f	mn
tks-cal	f	tks
xme-cim	f	xme-ker
arc-cpa	t	arc
xcg	t	cel-gau
az-cls	f	az
ms-cla	f	ms
fa-cls	t	fa
sa-cls	t	sa
tl-cls	t	tl
es-CO	f	es
bnt-cmn	f	bnt-pro
trk-cmn	f	trk-pro
cop-ggg	t	cop
cop-jjj	t	cop
cop-kkk	t	cop
cop-ppp	t	cop
grc-kre	f	grc-dor
el-crt	f	el
es-CU	f	es
el-cyp	f	el
dks-prk	t	pra
tks-dan	f	tks
prs	t	fa
fay-dsh	f	fay
fay-dav	f	fay
xme-del	f	xme-ker
os-dig	t	os
grc-dor	t	grc
drm-prk	t	pra
bry-ear	f	cel-bry-pro
cmn-ear	f	cmn
ltc-ear	f	ltc
ja-mid-ear	f	ja-mid
okm-ear	t	okm
xng-ear	f	xng
pal-ear	f	pal
cs-ear	f	cs
ja-ear	f	ja
och-ear	f	och
oos-ear	f	oos
peo-ear	f	peo
Early Scots	t	enm
O.Sc.	t	enm
Old Scots	t	enm
sco-osc	t	enm
sog-ear	f	sog
bal-eas	f	bal
bgp	f	bal
xme-ttc-eas	f	xme-ott
tks-ebr	f	tks
EL.	t	la
Ecclesiastical Latin	t	la
la-ecc	t	la
grc-ela	t	grc
fay-eze	f	fay
grc-epc	t	grc
tks-esf	f	tks
xme-far	f	xme-ker
cop-fay	t	cop
frk	f	gmw-pro
tly-fum	f	tly-sou
oc-gas	f	oc
fay-gav	f	fay
gzi	f	xme-ker
xme-gaz	f	xme-ker
en-geo	f	en
tmh-ght	t	tmh
aln	t	sq
nrf-grn	f	nrf
roa-grn	f	nrf
nan-hai	f	nan
xme-ham	f	xme-taf
xme-han	f	xme-ker
hae	f	om
arc-hat	t	arc
kn-hav	f	kn
inc-elu	t	pra
cop-her	t	cop
xum-her	f	xum
nan-hok	f	nan
bsg-hor	f	bsg
hvd-dv	f	dv
und-idn	f	und
arc-imp	t	arc
Ins.Sc.	f	sco
Insular Scots	f	sco
sco-ins	f	sco
grc-ion	t	grc
fa-ira	t	fa
os-iro	t	os
xme-isf	f	xme-ker
ps-jad	f	ps
nrf-jer	f	nrf
roa-jer	f	nrf
tmr	t	arc
arc-jla	t	arc
jpa	t	arc
nan-jj	f	nan-qz
rdb-jir	f	rdb
xme-jow	f	xme-ker
jrb	t	ar
xme-kaf	f	xme-ker
xme-kah	f	xme-taf
rdb-kah	f	rdb
kjv	t	sh
sh-kaj	t	sh
ps-kak	f	ps-sea
bsh-kam	f	bsh
xvi	f	bsh
ps-kan	f	ps-swe
oru-kan	f	oru
tly-kar	f	tly-cen
xme-kas	f	xme-ker
ncb-kat	f	ncb
gu-kat	f	gu
bsh-kat	f	bsh
xme-krm	f	xme-ker
xme-kes	f	xme-ker
mn-kha	f	mn
fay-kar	f	fay
inc-khs	t	pra
ps-xat	f	ps-nea
tks-xia	f	tks
fay-kho	f	fay
mn-khr	f	mn
tks-xoz	f	tks
sgh-xuf	f	sgh-rsx
sgh-xug	f	sgh-xgb
sgh-xgb	f	sgh
kfm	f	xme-ker
xme-xun	f	xme-ker
xme-xur	f	xme-ker
rw-kin	t	rw
rw-run	t	rw
Koine	t	grc
grc-koi	t	grc
xme-kom	f	xme-ker
fay-kon	f	fay
Kölsch	f	gmw-cfr
ksh	f	gmw-cfr
oc-lan	f	oc
akk-lbb	f	akk
bry-lat	f	cel-bry-pro
egy-lat	f	egx
kho-lat	f	kho-old
LL	t	la
LL.	t	la
Late Latin	t	la
la-lat	t	la
ltc-lat	f	ltc
ja-mid-lat	f	ja-mid
xng-lat	f	xng
pal-lat	f	pal
och-lat	f	och
oko-lat	f	oko
oos-lat	f	oos
peo-lat	f	peo
sog-lat	f	sog-ear
oc-lim	f	oc
gu-lda	f	gu
oru-log	f	oru
sc-src	f	sc
Lombardic	t	goh
goh-lng	t	goh
lng	t	goh
osc-luc	f	osc
Lunfardo	f	es
es-lun	f	es
cop-lyc	t	cop
inc-pmg	t	pra
xme-mah	f	xme-ker
inc-pmh	t	pra
ps-mah	f	ps-nwe
qwm-mam	f	qwm
mjg-min	f	mjg
xmn	f	pal
tly-msa	f	tly-sou
fay-mas	f	fay
tly-msu	f	tly-sou
he-med	t	he
ML	t	la
ML.	t	la
Medieval Latin	t	la
la-med	t	la
si-med	f	si
ang-mer	t	ang
es-MX	f	es
xme-mey	f	xme-ker
akk-mas	f	akk
akk-mbb	f	akk
cu-bgm	t	cu
egy-mid	f	egx
elx-mid	f	elx
ka-mid	t	ka
hi-mid	f	hi
ja-mid	f	ojp
kok-mid	t	kok
Mid.Sc.	f	enm
Middle Scots	f	enm
sco-smi	f	enm
ta-mid	f	ta
bsg-min	f	bsg
he-mis	t	he
inc-mit	f	inc-pro
he-IL	t	he
mjg-huz	f	mjg
mlk-dv	f	dv
bsh-mum	f	bsh
arc-nab	t	arc
ncb-nan	f	ncb
xme-nar	f	xme-ker
xme-nas	f	xme-ker
ntz	f	xme-ker
xme-nat	f	xme-ker
nyq	f	xme-ker
xme-nay	f	xme-ker
akk-nas	f	akk
akk-nbb	f	akk
elx-neo	f	elx
egy-nmi	f	egx
NL.	t	la
New Latin	t	la
la-new	t	la
sa-neo	t	sa
ko-ne	t	ko
ps-nea	f	ps
enm-nor	t	enm
Nor.Sc.	f	sco
Northern Scots	f	sco
sco-nor	f	sco
tly-nor	f	tly
xme-ttc-nor	f	xme-ott
ang-nor	t	ang
ko-nw	t	ko
ps-nwe	f	ps
sc-nuo	f	sc-src
xme-nus	f	xme-ker
odr-prk	t	pra
akk-old	f	akk
arc-old	t	arc
akk-oas	f	akk
ae-old	f	ae
awa-old	f	awa
xme-azr	f	xme-ott
akk-obb	f	akk
zle-obe	t	orv
bra-old	f	bra
cop-old	t	cop
non-oen	f	non
egy-old	f	egx
elx-old	f	elx
non-ogt	f	non
it-oit	f	it
roa-oit	f	it
fay-kzo	f	fay
kho-old	f	kho
otk-kir	f	otk
kok-old	t	kok
ms-old	f	ms
ONF.	f	fro
Old Northern French	f	fro
fro-nor	f	fro
oc-pro-old	f	pro
zle-oru	t	orv
fay-sho	f	fay
tl-old	t	tl
zle-ouk	t	orv
non-own	f	non
hsn-old	f	hsn
loc-opu	t	grc
mn-ord	f	mn
orc	f	om
sgh-oro	f	sgh-bro
cop-oxy	t	cop
loc-ozo	t	grc
inc-psi	t	pra
pfl	f	gmw-rfr
arc-pal	t	arc
grc-pam	t	grc
el-pap	f	el
fay-pap	f	fay
ps-pes	f	ps-nea
nan-ph	f	nan-jj
fro-pic	f	fro
zhx-pin	f	yue
prc-prk	t	pra
mkh-okm-P	f	mkh-okm
bat-pro	f	ine-bsl-pro
urj-fpr-pro	f	urj-pro
fiu-pro	f	urj-pro
cop-ply	t	cop
trk-ogz-pro	f	trk-pro
tbq-pro	f	sit-pro
oc-pro	f	oc
prv	f	oc
es-PR	f	es
xme-qal	f	xme-ker
xme-qoh	f	xme-ker
nan-qz	f	nan-hok
RL.	t	la
Renaissance Latin	t	la
la-ren	t	la
es-AR	f	es
sgh-ros	f	sgh-rsx
sgh-rsx	f	sgh
rdb-rud	f	rdb
sbr-prk	t	pra
tks-sag	f	tks
cop-sah	t	cop
ht-sdm	f	ht
skr-prk	t	pra
fay-sam	f	fay
osc-sam	f	osc
inc-pse	t	pra
xme-sed	f	xme-ker
tly-san	f	tly-sou
wuu-sha	f	wuu
tai-shz	f	za
ps-ser	f	ps-sea
fay-shr	f	fay
oc-jud	f	oc
sli	f	gmw-ecg
soj	f	xme-ker
xme-soi	f	xme-ker
fay-sor	f	fay
Borders Scots	f	sco
Sou.Sc.	f	sco
Southern Scots	f	sco
sco-sou	f	sco
ko-se	t	ko
ps-sea	f	ps
bal-sou	f	bal
bcc	f	bal
tly-sou	f	tly
xme-ttc-sou	f	xme-ott
ko-sw	t	ko
ps-swe	f	ps
gem-sue	f	gmw-pro
de-CH	f	de
Swiss French	f	fr
Switzerland French	f	fr
fr-CH	f	fr
Swiss Italian	f	it
Switzerland Italian	f	it
it-CH	f	it
tks-tak	f	tks
tly-tal	f	tly-cen
thv	t	tmh
taq	t	tmh
xme-trh	f	xme-ker
xme-tar	f	xme-ker
ttq	t	tmh
thz	t	tmh
grc-ths	f	grc-aeo
sh-tor	t	sh
als	t	sq
xtg	t	cel-gau
tly-tul	f	tly-cen
und-tdt	f	und
und-tdl	f	und
Uls.Sc.	f	sco
Ulster Scots	f	sco
sco-uls	f	sco
es-US	f	es
sxu	f	gmw-ecg
vaf	f	xme-taf
xme-vaf	f	xme-taf
ca-val	f	ca
xme-val	f	xme-ker
xme-var	f	xme-ker
xme-vrz	f	xme-ker
sa-ved	t	sa
VG.	f	de
Viennese German	f	de
de-AT-vie	f	de
oc-viv	f	oc
xme-von	f	xme-ker
VL.	t	la
Vulgar Latin	t	la
la-vul	t	la
ssn	f	om
ps-waz	f	ps-sea
bgn	f	bal
bal-wes	f	bal
xme-ttc-wes	f	xme-ott
woy	f	und
und-xbi	f	und
und-xnu	f	und
xme-yar	f	xme-ker
xme-yaz	f	xme-ker
ae-yng	f	ae-old
ko-yuk	t	ko
xme-zef	f	xme-ker
nan-zz	f	nan-hok
xme-zor	f	xme-ker
gbz	f	xme-ker
xme-dar	f	xme-ker
Tax.	f	mul
mul-tax	f	mul
aav	\N	aav
afa	\N	afa
alg	\N	alg
alv	\N	alv
apa	\N	apa
aqa	\N	aqa
aql	\N	aql
ath	\N	ath
auf	\N	auf
awd	\N	awd
azc	\N	azc
bad	\N	bad
bai	\N	bai
bat	\N	bat
ber	\N	ber
bnt	\N	bnt
btk	\N	btk
cba	\N	cba
ccn	\N	ccn
ccs	\N	ccs
cdc	\N	cdc
cdd	\N	cdd
cel	\N	cel
chi	\N	chi
cmc	\N	cmc
csu	\N	csu
cus	\N	cus
day	\N	day
del	\N	del
dmn	\N	dmn
dra	\N	dra
egx	\N	egx
esx	\N	esx
euq	\N	euq
gem	\N	gem
gme	\N	gme
gmq	\N	gmq
gmw	\N	gmw
grk	\N	grk
him	\N	him
hmn	\N	hmn
hmx	\N	hmx
hok	\N	hok
hyx	\N	hy
iir	\N	iir
ijo	\N	ijo
inc	\N	inc
ine	\N	ine
ira	\N	ira
iro	\N	iro
itc	\N	itc
jpx	\N	jpx
kar	\N	kar
kro	\N	kro
map	\N	map
mkh	\N	mkh
mno	\N	mno
mun	\N	mun
myn	\N	myn
ngf	\N	ngf
nic	\N	nic
nub	\N	nub
omq	\N	omq
omv	\N	omv
oto	\N	oto
phi	\N	phi
poz	\N	poz
pqe	\N	pqe
pra	\N	pra
qwe	\N	qwe
roa	\N	roa
sal	\N	sal
sdv	\N	sdv
sem	\N	sem
sio	\N	sio
sit	\N	sit
sla	\N	sla
smi	\N	smi
son	\N	son
sqj	\N	sq
ssa	\N	ssa
syd	\N	syd
tai	\N	tai
tbq	\N	tbq
trk	\N	trk
tup	\N	tup
tuw	\N	tuw
urj	\N	urj
wak	\N	wak
wen	\N	wen
xgn	\N	xgn
xme	\N	xme
xnd	\N	xnd
xsc	\N	xsc
ypk	\N	ypk
zhx	\N	zhx
zle	\N	zle
zls	\N	zls
zlw	\N	zlw
znd	\N	znd
aav-khs	\N	aav-khs
aav-nic	\N	aav-nic
aav-pkl	\N	aav-pkl
alg-abp	\N	alg-abp
alg-ara	\N	alg-ara
alg-eas	\N	alg-eas
alg-sfk	\N	alg-sfk
alv-aah	\N	alv-aah
alv-ada	\N	alv-ada
alv-bag	\N	alv-bag
alv-bak	\N	alv-bak
alv-bam	\N	alv-bam
alv-bny	\N	alv-bny
alv-bua	\N	bub
alv-bwj	\N	alv-bwj
alv-cng	\N	alv-cng
alv-ctn	\N	alv-ctn
alv-dlt	\N	alv-dlt
alv-dur	\N	alv-dur
alv-ede	\N	alv-ede
alv-edo	\N	alv-edo
alv-eeo	\N	alv-eeo
alv-fli	\N	fli
alv-fwo	\N	alv-fwo
alv-gba	\N	gba
alv-gbe	\N	alv-gbe
alv-gbf	\N	alv-gbf
alv-gbs	\N	alv-gbs
alv-gbw	\N	alv-gbw
alv-gda	\N	alv-gda
alv-gng	\N	alv-gng
alv-gtm	\N	alv-gtm
alv-hei	\N	hbn
alv-ido	\N	alv-ido
alv-igb	\N	alv-igb
alv-jfe	\N	alv-jfe
alv-jol	\N	alv-jol
alv-kim	\N	kia
alv-kis	\N	alv-kis
alv-krb	\N	alv-krb
alv-ktg	\N	alv-ktg
alv-kul	\N	alv-kul
alv-kwa	\N	alv-kwa
alv-lag	\N	alv-lag
alv-lek	\N	alv-lek
alv-lim	\N	alv-lim
alv-lni	\N	alv-lni
alv-mbd	\N	alv-mbd
alv-mbm	\N	mdd
alv-mel	\N	alv-mel
alv-mum	\N	mzm
alv-mye	\N	alv-mye
alv-nal	\N	naj
alv-nce	\N	alv-nce
alv-ngb	\N	alv-ngb
alv-ntg	\N	alv-ntg
alv-nup	\N	alv-nup
alv-nwd	\N	alv-nwd
alv-nyn	\N	alv-nyn
alv-pap	\N	pbo
alv-pph	\N	alv-pph
alv-ptn	\N	alv-ptn
alv-sav	\N	alv-sav
alv-sma	\N	alv-sma
alv-snf	\N	alv-snf
alv-sng	\N	alv-sng
alv-snr	\N	alv-snr
alv-swd	\N	alv-swd
alv-tal	\N	tlo
alv-tdj	\N	alv-tdj
alv-ten	\N	alv-ten
alv-the	\N	alv-the
alv-von	\N	alv-von
alv-wan	\N	alv-wan
alv-wjk	\N	alv-wjk
alv-yek	\N	ets
alv-yor	\N	alv-yor
alv-yun	\N	alv-yun
ath-nor	\N	ath-nor
ath-pco	\N	ath-pco
aus-arn	\N	aus-arn
aus-bub	\N	aus-bub
aus-cww	\N	aus-cww
aus-dal	\N	aus-dal
aus-dyb	\N	aus-dyb
aus-gar	\N	aus-gar
aus-gun	\N	aus-gun
aus-jar	\N	aus-jar
aus-kar	\N	aus-kar
aus-mir	\N	aus-mir
aus-nga	\N	aus-nga
aus-nyu	\N	aus-nyu
aus-pam	\N	aus-pam
aus-pmn	\N	aus-pmn
aus-psw	\N	aus-psw
aus-rnd	\N	aus-rnd
aus-tnk	\N	aus-tnk
aus-wdj	\N	aus-wdj
aus-wor	\N	aus-wor
aus-yid	\N	aus-yid
aus-yng	\N	aus-yng
aus-yol	\N	aus-yol
aus-yuk	\N	aus-yuk
awd-nwk	\N	awd-nwk
awd-taa	\N	awd-taa
azc-cup	\N	azc-cup
azc-nah	\N	azc-nah
azc-num	\N	azc-num
azc-tak	\N	azc-tak
azc-trc	\N	azc-trc
bad-cnt	\N	bad-cnt
bnt-baf	\N	ksf
bnt-bbo	\N	bnt-bbo
bnt-bdz	\N	bnt-bdz
bnt-bek	\N	bnt-bek
bnt-bki	\N	bnt-bki
bnt-bmo	\N	bnt-bmo
bnt-bne	\N	bnt-bne
bnt-bnm	\N	bnt-bnm
bnt-boa	\N	bnt-boa
bnt-bot	\N	bnt-bot
bnt-bsa	\N	bas
bnt-bsh	\N	buf
bnt-bso	\N	bnt-bso
bnt-bta	\N	bnt-bta
bnt-btb	\N	bnt-btb
bnt-bte	\N	bnt-bte
bnt-bun	\N	bnt-bun
bnt-chg	\N	bnt-chg
bnt-cht	\N	bnt-cht
bnt-clu	\N	bnt-clu
bnt-com	\N	bnt-com
bnt-glb	\N	bnt-glb
bnt-haj	\N	bnt-haj
bnt-kak	\N	kkj
bnt-kav	\N	bnt-kav
bnt-kbi	\N	bnt-kbi
bnt-kel	\N	bnt-kel
bnt-kil	\N	bnt-kil
bnt-kka	\N	bnt-kka
bnt-kmb	\N	kmb
bnt-kng	\N	kg
bnt-kpw	\N	bnt-kpw
bnt-ksb	\N	bnt-ksb
bnt-kts	\N	bnt-kts
bnt-lbn	\N	bnt-lbn
bnt-leb	\N	bnt-leb
bnt-lgb	\N	bnt-lgb
bnt-lok	\N	bnt-lok
bnt-lub	\N	bnt-lub
bnt-lun	\N	lun
bnt-mak	\N	bnt-mak
bnt-mbb	\N	bnt-mbb
bnt-mbe	\N	bnt-mbe
bnt-mbi	\N	bnt-mbi
bnt-mbo	\N	bnt-mbo
bnt-mbt	\N	bnt-mbt
bnt-mby	\N	bnt-mby
bnt-mij	\N	bnt-mij
bnt-mka	\N	mcp
bnt-mne	\N	bnt-mne
bnt-mnj	\N	bnt-mnj
bnt-mon	\N	lol
bnt-mra	\N	bnt-mra
bnt-msl	\N	bnt-msl
bnt-mwi	\N	bnt-mwi
bnt-ncb	\N	bnt-ncb
bnt-ndb	\N	bnt-ndb
bnt-ngn	\N	bnt-ngn
bnt-ngu	\N	bnt-ngu
bnt-nya	\N	nlj
bnt-nyb	\N	bnt-nyb
bnt-nyg	\N	bnt-nyg
bnt-nys	\N	bnt-nys
bnt-nze	\N	bnt-nze
bnt-ova	\N	bnt-ova
bnt-par	\N	asa
bnt-pen	\N	bnt-pen
bnt-pob	\N	bnt-pob
bnt-ruk	\N	bnt-ruk
bnt-run	\N	bnt-run
bnt-rur	\N	bnt-rur
bnt-ruv	\N	bnt-ruv
bnt-rvm	\N	bnt-rvm
bnt-sab	\N	bnt-sab
bnt-saw	\N	bnt-saw
bnt-sbi	\N	bnt-sbi
bnt-seu	\N	bnt-seu
bnt-shh	\N	bnt-shh
bnt-sho	\N	sn
bnt-sir	\N	swj
bnt-ske	\N	bnt-ske
bnt-sna	\N	seh
bnt-sts	\N	bnt-sts
bnt-swb	\N	bnt-swb
bnt-swh	\N	sw
bnt-tek	\N	bnt-tek
bnt-tet	\N	tll
bnt-tkc	\N	nzu
bnt-tkm	\N	bnt-tkm
bnt-tmb	\N	bnt-tmb
bnt-tso	\N	tsv
bnt-tsr	\N	bnt-tsr
bnt-yak	\N	yaf
bnt-yko	\N	bnt-yko
bnt-zbi	\N	bnt-zbi
cau-abz	\N	cau-abz
cau-ava	\N	cau-ava
cau-cir	\N	cau-cir
cau-drg	\N	dar
cau-lzg	\N	cau-lzg
cau-nec	\N	cau-nec
cau-nkh	\N	cau-nkh
cau-nwc	\N	cau-nwc
cau-tsz	\N	cau-tsz
cau-vay	\N	cau-vay
ccs-gzn	\N	ccs-gzn
ccs-zan	\N	ccs-zan
cdc-cbm	\N	cdc-cbm
cdc-est	\N	cdc-est
cdc-mas	\N	cdc-mas
cdc-wst	\N	cdc-wst
cel-bry	\N	cel-bry
cel-gae	\N	cel-gae
csu-bba	\N	csu-bba
csu-bbk	\N	csu-bbk
csu-bgr	\N	bmi
csu-bkr	\N	csu-bkr
csu-ecs	\N	csu-ecs
csu-kab	\N	ksp
csu-lnd	\N	led
csu-maa	\N	mdj
csu-mle	\N	csu-mle
csu-mma	\N	csu-mma
csu-sar	\N	sre
csu-val	\N	vae
cus-cen	\N	cus-cen
cus-eas	\N	cus-eas
cus-hec	\N	cus-hec
cus-sou	\N	cus-sou
dmn-bbu	\N	dmn-bbu
dmn-emn	\N	dmn-emn
dmn-jje	\N	dmn-jje
dmn-man	\N	dmn-man
dmn-mda	\N	dmn-mda
dmn-mdc	\N	dmn-mdc
dmn-mde	\N	dmn-mde
dmn-mdw	\N	dmn-mdw
dmn-mjo	\N	dmn-mjo
dmn-mmo	\N	dmn-mmo
dmn-mnk	\N	dmn-mnk
dmn-mnw	\N	dmn-mnw
dmn-mok	\N	mkl
dmn-mse	\N	dmn-mse
dmn-msw	\N	dmn-msw
dmn-mva	\N	dmn-mva
dmn-nbe	\N	dmn-nbe
dmn-sam	\N	smq
dmn-smg	\N	dmn-smg
dmn-snb	\N	dmn-snb
dmn-sya	\N	dmn-sya
dmn-vak	\N	dmn-vak
dmn-wmn	\N	dmn-wmn
esx-esk	\N	esx-esk
esx-inu	\N	esx-inu
fiu-fin	\N	fiu-fin
gmw-fri	\N	gmw-fri
hmx-mie	\N	hmx-mie
iir-nur	\N	iir-nur
inc-bhi	\N	inc-bhi
inc-cen	\N	inc-cen
inc-dar	\N	inc-dar
inc-eas	\N	inc-eas
inc-hie	\N	inc-hie
inc-hiw	\N	inc-hiw
inc-hnd	\N	inc-hnd
inc-ins	\N	inc-ins
inc-mid	\N	inc-mid
inc-nor	\N	inc-nor
inc-nwe	\N	inc-nwe
inc-old	\N	inc-old
inc-pah	\N	inc-pah
inc-pan	\N	inc-pan
inc-psu	\N	pra
inc-rom	\N	rom
inc-snd	\N	sd
inc-sou	\N	inc-sou
inc-wes	\N	inc-wes
ine-ana	\N	ine-ana
ine-bsl	\N	ine-bsl
ine-toc	\N	ine-toc
ira-cen	\N	ira-cen
ira-csp	\N	ira-csp
ira-kms	\N	ira-kms
ira-mny	\N	ira-mny
ira-mpr	\N	ira-mpr
ira-msh	\N	ira-msh
ira-nei	\N	ira-nei
ira-nwi	\N	ira-nwi
ira-orp	\N	ira-orp
ira-pat	\N	ira-pat
ira-sbc	\N	ira-sbc
ira-sei	\N	ira-sei
ira-sgc	\N	ira-sgc
ira-sgi	\N	ira-sgi
ira-shy	\N	ira-shy
ira-swi	\N	ira-swi
ira-sym	\N	ira-sym
ira-wes	\N	ira-wes
ira-zgr	\N	ira-zgr
jpx-ryu	\N	jpx-ryu
khi-kal	\N	khi-kal
khi-khk	\N	naq
khi-kho	\N	khi-kho
khi-kkw	\N	khi-kkw
khi-kxa	\N	khi-kxa
khi-tuu	\N	khi-tuu
kro-aiz	\N	kro-aiz
kro-bet	\N	kro-bet
kro-did	\N	kro-did
kro-ekr	\N	kro-ekr
kro-grb	\N	grb
kro-wee	\N	kro-wee
kro-wkr	\N	kro-wkr
map-ata	\N	map-ata
mkh-asl	\N	mkh-asl
mkh-ban	\N	mkh-ban
mkh-kat	\N	mkh-kat
mkh-khm	\N	mkh-khm
mkh-kmr	\N	mkh-kmr
mkh-mnc	\N	mkh-mnc
mkh-mng	\N	mkh-mng
mkh-nbn	\N	mkh-nbn
mkh-pal	\N	mkh-pal
mkh-pea	\N	mkh-pea
mkh-pkn	\N	mkh-pkn
mkh-vie	\N	mkh-vie
nai-cat	\N	nai-cat
nai-chu	\N	nai-chu
nai-ckn	\N	nai-ckn
nai-coo	\N	nai-coo
nai-ker	\N	nai-ker
nai-klp	\N	nai-klp
nai-kta	\N	nai-kta
nai-len	\N	nai-len
nai-mdu	\N	nai-mdu
nai-min	\N	nai-min
nai-miz	\N	nai-miz
nai-mus	\N	nai-mus
nai-pak	\N	nai-pak
nai-pal	\N	nai-pal
nai-plp	\N	nai-plp
nai-pom	\N	nai-pom
nai-sca	\N	nai-sca
nai-shp	\N	nai-shp
nai-shs	\N	nai-shs
nai-tot	\N	nai-tot
nai-tqn	\N	nai-tqn
nai-tsi	\N	nai-tsi
nai-ttn	\N	nai-ttn
nai-utn	\N	nai-utn
nai-wtq	\N	nai-wtq
nai-xin	\N	nai-xin
nai-yok	\N	nai-yok
nai-you	\N	nai-you
nai-yuc	\N	nai-yuc
ngf-fin	\N	ngf-fin
ngf-mad	\N	ngf-mad
ngf-okk	\N	ngf-okk
ngf-sbh	\N	ngf-sbh
nic-alu	\N	nic-alu
nic-bas	\N	bzw
nic-bbe	\N	nic-bbe
nic-bco	\N	nic-bco
nic-bcr	\N	nic-bcr
nic-bdn	\N	nic-bdn
nic-bds	\N	nic-bds
nic-beb	\N	nic-beb
nic-ben	\N	bct
nic-beo	\N	nic-beo
nic-bod	\N	nic-bod
nic-buk	\N	nic-buk
nic-bwa	\N	bww
nic-cde	\N	nic-cde
nic-cri	\N	nic-cri
nic-dag	\N	dag
nic-dak	\N	nic-dak
nic-dge	\N	nic-dge
nic-dgw	\N	nic-dgw
nic-eko	\N	nic-eko
nic-eov	\N	nic-eov
nic-fru	\N	fuu
nic-gne	\N	nic-gne
nic-gnn	\N	nic-gnn
nic-gns	\N	nic-gns
nic-gnw	\N	nic-gnw
nic-gre	\N	nic-gre
nic-grf	\N	nic-grf
nic-grm	\N	nic-grm
nic-grs	\N	nic-grs
nic-gur	\N	nic-gur
nic-ief	\N	nic-ief
nic-jer	\N	nic-jer
nic-jkn	\N	nic-jkn
nic-jrn	\N	nic-jrn
nic-jrw	\N	anq
nic-kam	\N	nic-kam
nic-kau	\N	nic-kau
nic-kmk	\N	nic-kmk
nic-kne	\N	nic-kne
nic-knj	\N	nic-knj
nic-knn	\N	nic-knn
nic-ktl	\N	nic-ktl
nic-lcr	\N	nic-lcr
nic-mam	\N	nic-mam
nic-mba	\N	nic-mba
nic-mbc	\N	mfc
nic-mbw	\N	nic-mbw
nic-mmb	\N	nic-mmb
nic-mom	\N	nic-mom
nic-mre	\N	nic-mre
nic-ngd	\N	nic-ngd
nic-nge	\N	nge
nic-ngk	\N	nga
nic-nin	\N	nic-nin
nic-nka	\N	nic-nka
nic-nkb	\N	bkc
nic-nke	\N	nic-nke
nic-nkg	\N	gbg
nic-nkk	\N	kpl
nic-nkm	\N	nic-nkm
nic-nkw	\N	nic-nkw
nic-npd	\N	nic-npd
nic-nun	\N	nic-nun
nic-nwa	\N	nic-nwa
nic-ogo	\N	nic-ogo
nic-ovo	\N	nic-ovo
nic-pla	\N	nic-pla
nic-plc	\N	nic-plc
nic-pld	\N	nic-pld
nic-ple	\N	nic-ple
nic-pls	\N	nic-pls
nic-plt	\N	nic-plt
nic-ras	\N	nic-ras
nic-rnc	\N	nic-rnc
nic-rng	\N	nic-rng
nic-rnn	\N	nic-rnn
nic-rnw	\N	nic-rnw
nic-ser	\N	swf
nic-shi	\N	nic-shi
nic-sis	\N	nic-sis
nic-tar	\N	nic-tar
nic-tiv	\N	nic-tiv
nic-tvc	\N	nic-tvc
nic-tvn	\N	nic-tvn
nic-ubg	\N	nic-ubg
nic-uce	\N	nic-uce
nic-ucn	\N	nic-ucn
nic-ucr	\N	nic-ucr
nic-vco	\N	nic-vco
nic-wov	\N	nic-wov
nic-ykb	\N	nic-ykb
nic-ymb	\N	nic-ymb
nic-yon	\N	nic-yon
nub-hil	\N	nub-hil
nur-nor	\N	nur-nor
nur-sou	\N	nur-sou
omq-cha	\N	omq-cha
omq-chi	\N	omq-chi
omq-cui	\N	omq-cui
omq-maz	\N	omq-maz
omq-mix	\N	omq-mix
omq-mxt	\N	omq-mxt
omq-otp	\N	omq-otp
omq-pop	\N	omq-pop
omq-tri	\N	omq-tri
omq-zap	\N	omq-zap
omq-zpc	\N	zap
omv-aro	\N	omv-aro
omv-diz	\N	omv-diz
omv-eom	\N	omv-eom
omv-gon	\N	omv-gon
omv-mao	\N	omv-mao
omv-nom	\N	omv-nom
omv-ome	\N	omv-ome
oto-otm	\N	oto-otm
paa-arf	\N	paa-arf
paa-asa	\N	paa-asa
paa-bng	\N	paa-bng
paa-brd	\N	paa-brd
paa-egb	\N	paa-egb
paa-eng	\N	paa-eng
paa-iwm	\N	iwm
paa-kag	\N	paa-kag
paa-kiw	\N	paa-kiw
paa-kut	\N	paa-kut
paa-kwm	\N	kwo
paa-lkp	\N	paa-lkp
paa-lsp	\N	paa-lsp
paa-mai	\N	zrs
paa-msk	\N	paa-msk
paa-nbo	\N	paa-nbo
paa-nha	\N	paa-nha
paa-nim	\N	nir
paa-pag	\N	paa-pag
paa-pau	\N	paa-pau
paa-ram	\N	paa-ram
paa-sbo	\N	paa-sbo
paa-sen	\N	set
paa-spk	\N	paa-spk
paa-tkw	\N	paa-tkw
paa-wpa	\N	paa-wpa
paa-yam	\N	paa-yam
paa-yua	\N	paa-yua
phi-kal	\N	phi-kal
poz-aay	\N	poz-aay
poz-bnn	\N	poz-bnn
poz-bop	\N	poz-bop
poz-bre	\N	poz-bre
poz-brw	\N	poz-brw
poz-btk	\N	poz-btk
poz-cet	\N	poz-cet
poz-clb	\N	poz-clb
poz-cln	\N	poz-cln
poz-cma	\N	poz-cma
poz-hce	\N	poz-hce
poz-kal	\N	poz-kal
poz-lgx	\N	poz-lgx
poz-mcm	\N	poz-mcm
poz-mic	\N	poz-mic
poz-mly	\N	poz-mly
poz-msa	\N	poz-msa
poz-mun	\N	poz-mun
poz-nws	\N	poz-nws
poz-occ	\N	poz-occ
poz-oce	\N	poz-oce
poz-ocw	\N	poz-ocw
poz-pep	\N	poz-pep
poz-pnp	\N	poz-pnp
poz-pol	\N	poz-pol
poz-san	\N	poz-san
poz-sbj	\N	poz-sbj
poz-slb	\N	poz-slb
poz-sls	\N	poz-sls
poz-ssw	\N	poz-ssw
poz-sus	\N	poz-sus
poz-swa	\N	poz-swa
poz-tim	\N	poz-tim
poz-tot	\N	poz-tot
poz-vnc	\N	poz-vnc
poz-wot	\N	poz-wot
qfa-adc	\N	qfa-adc
qfa-adm	\N	qfa-adm
qfa-adn	\N	qfa-adn
qfa-ads	\N	qfa-ads
qfa-bet	\N	qfa-bet
qfa-buy	\N	qfa-buy
qfa-cka	\N	qfa-cka
qfa-dgn	\N	qfa-dgn
qfa-dny	\N	qfa-dny
qfa-gel	\N	gio
qfa-hur	\N	qfa-hur
qfa-kad	\N	qfa-kad
qfa-kms	\N	qfa-kms
qfa-kor	\N	qfa-kor
qfa-kra	\N	qfa-kra
qfa-lic	\N	lic
qfa-mal	\N	qfa-mal
qfa-mch	\N	qfa-mch
qfa-onb	\N	qfa-onb
qfa-ong	\N	qfa-ong
qfa-sub	\N	qfa-sub
qfa-tak	\N	qfa-tak
qfa-tap	\N	qfa-tap
qfa-tor	\N	tei
qfa-tyn	\N	qfa-tyn
qfa-yen	\N	qfa-yen
qfa-yuk	\N	qfa-yuk
roa-eas	\N	roa-eas
roa-git	\N	roa-git
roa-ibe	\N	roa-ibe
roa-itd	\N	roa-itd
roa-oil	\N	roa-oil
roa-rhe	\N	roa-rhe
sai-ara	\N	sai-ara
sai-aym	\N	sai-aym
sai-bar	\N	sai-bar
sai-bor	\N	sai-bor
sai-cah	\N	sai-cah
sai-car	\N	sai-car
sai-cer	\N	sai-cer
sai-chc	\N	sai-chc
sai-cho	\N	sai-cho
sai-cje	\N	sai-cje
sai-cpc	\N	sai-cpc
sai-crn	\N	sai-crn
sai-ctc	\N	sai-ctc
sai-guc	\N	sai-guc
sai-guh	\N	sai-guh
sai-har	\N	sai-har
sai-hkt	\N	sai-hkt
sai-hoc	\N	sai-hoc
sai-hrp	\N	sai-hrp
sai-jee	\N	sai-jee
sai-jir	\N	sai-jir
sai-jiv	\N	sai-jiv
sai-ktk	\N	sai-ktk
sai-mas	\N	sai-mas
sai-mgc	\N	sai-mgc
sai-mje	\N	sai-mje
sai-mtc	\N	sai-mtc
sai-mur	\N	sai-mur
sai-nad	\N	sai-nad
sai-nje	\N	sai-nje
sai-nmk	\N	sai-nmk
sai-otm	\N	sai-otm
sai-pan	\N	sai-pan
sai-pat	\N	sai-pat
sai-sje	\N	sai-sje
sai-tac	\N	sai-tac
sai-tuc	\N	sai-tuc
sai-tyu	\N	sai-tyu
sai-ucp	\N	sai-ucp
sai-wic	\N	sai-wic
sai-wit	\N	sai-wit
sai-ynm	\N	sai-ynm
sai-zam	\N	sai-zam
sai-zap	\N	sai-zap
sdv-bri	\N	bfa
sdv-daj	\N	sdv-daj
sdv-dnu	\N	sdv-dnu
sdv-eje	\N	sdv-eje
sdv-kln	\N	kln
sdv-lma	\N	sdv-lma
sdv-lon	\N	sdv-lon
sdv-los	\N	sdv-los
sdv-luo	\N	luo
sdv-nes	\N	sdv-nes
sdv-nie	\N	sdv-nie
sdv-nil	\N	sdv-nil
sdv-nis	\N	sdv-nis
sdv-niw	\N	sdv-niw
sdv-nma	\N	sdv-nma
sdv-nyi	\N	sdv-nyi
sdv-tmn	\N	sdv-tmn
sdv-ttu	\N	sdv-ttu
sem-ara	\N	arc
sem-arb	\N	ar
sem-are	\N	sem-are
sem-arw	\N	sem-arw
sem-ase	\N	sem-ase
sem-can	\N	sem-can
sem-cen	\N	sem-cen
sem-cna	\N	sem-cna
sem-eas	\N	sem-eas
sem-eth	\N	sem-eth
sem-nna	\N	sem-nna
sem-nwe	\N	sem-nwe
sem-osa	\N	sem-osa
sem-sar	\N	sem-sar
sem-wes	\N	sem-wes
sgn-fsl	\N	sgn-fsl
sgn-gsl	\N	sgn-gsl
sgn-jsl	\N	sgn-jsl
sio-dhe	\N	sio-dhe
sio-dkt	\N	sio-dkt
sio-mor	\N	sio-mor
sio-msv	\N	sio-msv
sio-ohv	\N	sio-ohv
sit-aao	\N	njo
sit-alm	\N	sit-alm
sit-bdi	\N	sit-bdi
sit-dhi	\N	sit-dhi
sit-ebo	\N	sit-ebo
sit-gma	\N	sit-gma
sit-gsi	\N	sit-gsi
sit-hrs	\N	sit-hrs
sit-jnp	\N	sit-jnp
sit-jpl	\N	sit-jpl
sit-kch	\N	sit-kch
sit-kha	\N	kjl
sit-khb	\N	sit-khb
sit-kic	\N	sit-kic
sit-kie	\N	sit-kie
sit-kin	\N	kfk
sit-kir	\N	sit-kir
sit-kiw	\N	sit-kiw
sit-kon	\N	sit-kon
sit-kyk	\N	sit-kyk
sit-lab	\N	sit-lab
sit-las	\N	sit-las
sit-luu	\N	sit-luu
sit-mar	\N	sit-mar
sit-mdz	\N	sit-mdz
sit-mnz	\N	sit-mnz
sit-mru	\N	sit-mru
sit-nax	\N	sit-nax
sit-new	\N	sit-new
sit-nng	\N	sit-nng
sit-qia	\N	sit-qia
sit-rgy	\N	sit-rgy
sit-tam	\N	sit-tam
sit-tan	\N	sit-tan
sit-tib	\N	sit-tib
sit-tja	\N	sit-tja
sit-tma	\N	sit-tma
sit-tng	\N	sit-tng
sit-tno	\N	sit-tno
sit-tsk	\N	tsj
sit-whm	\N	sit-whm
sit-zem	\N	sit-zem
ssa-fur	\N	fvr
ssa-klk	\N	ssa-klk
ssa-kom	\N	ssa-kom
ssa-sah	\N	ssa-sah
tai-cen	\N	tai-cen
tai-cho	\N	tai-cho
tai-nor	\N	tai-nor
tai-sap	\N	tai-sap
tai-swe	\N	tai-swe
tai-tay	\N	tyz
tai-wen	\N	tai-wen
tbq-anp	\N	tbq-anp
tbq-bdg	\N	tbq-bdg
tbq-bkj	\N	tbq-bkj
tbq-brm	\N	tbq-brm
tbq-buq	\N	tbq-buq
tbq-kuk	\N	tbq-kuk
tbq-lal	\N	tbq-lal
tbq-lob	\N	tbq-lob
tbq-lol	\N	tbq-lol
trk-kar	\N	trk-kar
trk-kbu	\N	trk-kbu
trk-kcu	\N	trk-kcu
trk-kip	\N	qwm
trk-kno	\N	trk-kno
trk-ogr	\N	trk-ogr
trk-ogz	\N	trk-ogz
trk-sib	\N	trk-sib
tup-gua	\N	tup-gua
urj-mdv	\N	urj-mdv
urj-prm	\N	urj-prm
urj-ugr	\N	urj-ugr
xme-ttc	\N	xme-ttc
xsc-sak	\N	xsc-sak
xsc-skw	\N	xsc-skw
zhx-gba	\N	zhx-gba
zhx-min	\N	zhx-min
zhx-min-hai	\N	zhx-min-hai
zhx-min-shn	\N	zhx-min-shn
zlw-lch	\N	zlw-lch
art	\N	art
crp	\N	crp
paa	\N	paa
qfa-iso	\N	qfa-iso
qfa-mix	\N	qfa-mix
qfa-not	\N	qfa-not
sgn	\N	sgn
\.
